border_size=1
usage=map

Gll^Fp, Gll^Fp, Gll^Fp, Gll^Fp, Gll^Fp, Gll^Fp, Gll^Fp, Gll^Fp, Gll^Fp, Gll^Fp, Gll^Fp, Gll^Fp, Gll^Fp, Gll^Fp, Gll^Fp, Gll^Fp, Gll^Fp, Gll^Fp, Gll^Fp, Gll^Fp, Gll^Fp, Gll^Fp, Gll^Fp, Gll^Fp, Gll^Fp, Gll^Fp, Gll^Fp, Gll^Fp, Gll^Fp, Gll^Fp, Gll^Fp, Gll^Fp, Gll^Fdw, Gll^Fp, Gll^Fp, Gll^Fp, Gll^Fp, Gll^Fp, Gll^Fp, Gll^Fp, Gll^Fp, Gll^Fp, Gll^Fp, Gll^Fp, Gll^Fp, Gll^Fp, Gll^Fp, Gll^Fp, Gll^Fp, Gll^Fp, Gll^Fp, Gll^Fp
Gll^Fp, Gll^Fp, Gll^Fp, Gll^Fp, Gll^Fp, Gll^Fp, Gll^Fp, Gll^Fp, Gll^Fp, Gll^Fp, Gll^Fp, Gll^Fp, Gll^Fp, Gll^Fp, Gll^Fp, Gll^Fp, Gll^Fp, Gll^Fp, Gll^Fp, Gll^Fp, Gll^Fp, Gll^Fp, Gll^Fp, Gll^Fp, Gll^Fp, Gll^Fp, Gll^Fp, Gll^Fp, Gll^Fp, Gll^Fp, Gll^Fp, Gll^Fdw, Gll^Fp, Gll^Fp, Gll^Fdw, Gll^Fp, Gll^Fp, Gll^Fp, Gll^Fp, Gll^Fp, Gll^Fp, Gll^Fp, Gll^Fp, Gll^Fp, Gll^Fdw, Gd, Gd, Gll^Fp, Gll^Fdw, Gll^Fp, Gll^Fdw, Gll^Fp
Gll^Fp, Gll^Fp, Gll^Fp, Gll^Fp, Gll^Fp, Gll^Fp, Gll^Fp, Gll^Fp, Gll^Fp, Gll^Fp, Gll^Fp, Gll^Fp, Gll^Fp, Gll^Fp, Gll^Fp, Gll^Fp, Gll^Fp, Gll^Fp, Gll^Fp, Gll^Fp, Gll^Fp, Gll^Fp, Gg^Ve, Gll^Fp, Gg, Gll^Fp, Gll^Fp, Gll^Fp, Gll^Fp, Gll^Fp, Gll^Fp, Gll^Fdw, Gd, Gll^Fdw, Gd, Gll^Fp, Gll^Fdw, Gll^Fp, Gd, Gll^Fp, Gll^Fp, Gll^Fp, Gll^Fp, Gll^Fp, Gll^Fdw, Gd, Gll^Fdw, Gd, Gd, Gll^Fdw, Gll^Fdw, Gll^Fdw
Gll^Fp, Gll^Fp, Gll^Fp, Gll^Fp, Gll^Fp, Gll^Fp, Gll^Fp, Gll^Fp, Xuc, Xuc, Xuc, Gll^Fp, Gll^Fp, Gll^Fp, Gll^Fp, Gll^Fp, Wwt, Gll^Fp, Gll^Fp, Gll^Fp, Gll^Fp, Gll^Fp, Gg, Gg, Gg, Gll^Fp, Gg, Gll^Fp, Gll^Fp, Gll^Fp, Gll^Fp, Gll^Fp, Gll^Fp, Gd, Gd, Gll^Fdw, Gll^Fdw, Gll^Fdw, Gd, Gll^Fp, Gll^Fp, Gll^Fp, Gll^Fdw, Gll^Fdw, Gd, Gd, Gll^Fdw, Gll^Fdw, Gd, Gd, Gll^Fdw, Gll^Fdw
Gll^Fp, Gll^Fp, Gll^Fp, Gll^Fp, Gll^Fp, Gll^Fp, Xuc, Xuc, Gll^Fp, Gll^Fp, Gll^Fp, Xuc, Xuc, Gll^Fp, Gll^Fp, Wwt, Ww^Ewf, Wwt, Wwt, Gll^Fp, Gll^Fp, Gg, Gll^Fp, Gll^Fp, Gg, Gg^Efm, Gg, Gg^Ve, Gll^Fp, Gll^Fp, Gll^Fp, Gll^Fp, Gll^Fdw, Gll^Fp, Gd, Gd, Gd, Gll^Fdw, Gd, Gll^Fp, Gd, Gll^Fdw, Gd, Gd, Gd, Gll^Fdw, Gd, Gd, Gd, Gd, Gll^Fdw, Gll^Fdw
Gll^Fp, Gll^Fp, Gll^Fp, Gll^Fp, Gll^Fp, Xuc, Gll^Fp, Gll^Fp, Gll^Fp, Gll^Fp, Gll^Fp, Gll^Fp, Gll^Fp, Gll^Fp, Gll^Fp, Wwt, Wwrt, Ww^Ewf, Wwt, Gll^Fp, Gll^Fp, Gll^Fp, Gll^Fp, Gll^Fp, Gll^Fp, Gg, Gll^Fp, Gll^Fp, Gll^Fp, Gll^Fp, Gll^Fdw, Gll^Fdw, Gll^Fdw, Gll^Fdw, Gd, Gd, Gd, Gd, Gd, Gd, Gd, Gd, Gd, Gd, Gd, Gd, Gd, Gd^Fetd, Gd, Gd, Gg, Gg
Gll^Fp, Gll^Fp, Gll^Fp, Gll^Fp, Gll^Fp, Xuc, Gll^Fp, Gll^Fp, Gll^Fp, Gll^Fp, Gll^Fp, Gll^Fp, Gll^Fp, Gll^Fp, Gll^Fp, Gll^Fp, Gll^Fp, Wwrt, Gll^Fp, Gll^Fp, Gll^Fp, Gll^Fp, Gll^Fp, Gll^Fp, Gll^Fp, Gll^Fp, Gll^Fp, Gll^Fp, Gll^Fp, Gll^Fp, Gll^Fp, Gd, Gd, Gll^Fdw, Gd, Gd, Gd, Gd, Gll^Fdw, Gll^Fdw, Gd, Gd, Gd^Fetd, Gd, Gd, Gd, Gd, Gd, Gd, Gd, Gd, Gg
Gll^Fp, Gll^Fp, Gll^Fp, Gll^Fp, Gll^Fp, Xuc, Gll^Fp, Gll^Fp, Gll^Fp, Gg^Fet, Gll^Fp, Gll^Fp, Gll^Fp, Gll^Fp, Gll^Fp, Gll^Fp, Gll^Em, Gll^Fp, Gll^Em, Gll^Fp, Gll^Fp, Gll^Fp, Gg, Gll^Fp, Gll^Fp, Gll^Es, Gll^Fp, Gll^Fp, Gll^Fp, Gll^Fdw, Gll^Fdw, Gll^Fp, Gd, Gd, Gd, Gd, Gd, Gd, Gd, Gd, Gd, Gd, Gd, Gd, Gd, Gd, Re, Gd, Gd, Gd, Gd, Gd
Gg, Gll^Fp, Gll^Fp, Gll^Fp, Gll^Fp, Xuc, Gll^Fp, Gll^Fp, Gll^Fp, Gll^Fp, Gll^Fp, Gll^Fp, Gll^Fp, Gll^Fp, Gll^Fp, Gll^Fp, Gll^Fp, Gll^Emf, Gll^Fp, Gll^Fp, Gll^Fp, Gg, Gg^Ve, Gll^Fp, Gll^Fp, Gll^Fp, Gll^Fp, Gll^Fp, Gd, Gll^Fdw, Gd, Gd, Gll^Fdw, Gll^Fdw, Gd, Gd, Gd, Gd, Gd, Gd, Rd, Rd, Rd, Gll^Fdw, Gll^Fdw, Re, Re, Re, Re, Re, Re, Re
Gll^Fp, Gll^Fp, Gll^Fp, Gll^Fp, Gll^Fp, Xuc, Xuc, Gll^Fp, Gll^Fp, Gll^Fp, Gll^Fp, Gll^Fp, Gll^Fp, Gll^Fp, Gll^Fp, Gll^Fp, Gg^Efm, Gll^Em, Gll^Fp, Gll^Fp, Gg, Gg, Gll^Fp, Gll^Fp, Gll^Fp, Gll^Fp, Gll^Fp, Gll^Fp, Gd, Gd, Gd, Gd, Gd, Gll^Fdw, Gd, Gd^Fetd, Gd, Gd, Re, Re, Re, Re, Rd, Rd, Re, Re, Re, Re, Re, Re, Re, Re
Gll^Fp, Gll^Fp, Gll^Fp, Gll^Fp, Gll^Fp, Gll^Fp, Gll^Fp, Xuc, Xuc, Gll^Fp, Gll^Fp, Gll^Fp, Gll^Fp, Gll^Fp, Gll^Fp, Gg, Gll^Efm, Gg, 1 Kv, Cv, Gll^Fp, Gll^Fp, Gll^Fp, Gll^Fp, Gll^Es, Gll^Fp, Gll^Fp, Gll^Fp, Gll^Fdw, Gd, Gd, Gd, Gd, Gd, Gd, Gd, Gll^Fdw, Re, Re, Re, Re, Re, Re, Rd, Rd, Re, Rb, Rb, Rb, Rb, Rb, Rb
Gll^Fp, Gll^Fp, Gll^Fp, Gll^Fp, Gll^Fp, Gll^Fp, Gll^Fp, Gll^Fp, Gll^Fp, Gll^Fp, Gll^Fp, Gll^Emf, Gll^Fp, Gll^Fp, Gll^Fp, Gg, Gg, Gg, Cv, Cv, Gll^Fp, Gll^Fp, Gll^Fp, Gll^Es, Gll^Fp, Gll^Fp, Gll^Fp, Gll^Fdw, Gll^Fdw, Gll^Fdw, Gd, Gd, Gd, Gd, Gd, Re, Re, Gll^Fdw, Re, Re, Re, Re, Rb, Re, Re^Vct, Rb, Rb, Rb, Rb, Rb, Rb, Rb
Gll^Fp, Gll^Fp, Gll^Fp, Gll^Fp, Gll^Fp, Gll^Fp, Gll^Fp, Gll^Fp, Gll^Fp, Gll^Fp, Gll^Fp, Gll^Em, Gll^Fp, Gll^Fp, Gll^Fp, Gll^Fp, Gll^Fp, Gg, Gg, Gg, Gg, Gll^Fp, Gll^Fp, Gll^Fp, Gll^Fp, Gll^Fp, Gll^Fp, Gll^Fp, Gll^Fp, Gll^Fp, Gd, Gd, Gd, Gd, Gd, Re, Re, Re, Re, Re^Vct, Rb, Rb, Rb^Ecf, Rb, Rb^Edb, Rb, Rb, Rb, Qlf, Rb, Qlf, Rb
Gll^Fp, Gll^Fp, Gll^Fp, Gll^Es, Gll^Efm, Gll^Fp, Gll^Fp, Gll^Es, Gll^Fp, Gll^Fp, Gll^Fp, Gll^Fp, Gg^Ve, Gll^Fp, Gll^Fp, Gll^Em, Gll^Fp, Gll^Fp, Gg, Gg, Gg^Ve, Gg, Gll^Fp, Gll^Fp, Gll^Fp, Gll^Fp, Gll^Fdw, Gll^Fp, Gll^Fp, Gd, Gd, Gd, Gll^Fdw, Gd, Rd, Rd, Re, Re, Re, Rb, Rb^Edb, Rb, Rb, Rb, Re^Vct, Rb, Qlf, Qlf, Ql, Qlf, Qlf, Qlf
Gll^Fp, Gll^Fp, Gll^Fp, Gll^Fp, Gll^Fp, Gll^Fp, Gll^Fp, Gll^Fp, Gll^Es, Gll^Fp, Gll^Fp, Gg, Gg, Gll^Fp, Gll^Fp, Gll^Efm, Gll^Fp, Gll^Fp, Gg, Gg, Gg, Gll^Fp, Gll^Fp, Gll^Fp, Gd, Gll^Fdw, Gd, Gll^Fdw, Gd, Gd, Gd, Gd, Gll^Fdw, Gd, Rd, Rd, Re, Re, Rb^Edb, Rb, Rb, Rb, Ce, Rb, Rb^Edb, Rb, Qlf, Ql, Ql, Qlf, Qlf, Qlf
Gll^Fp, Gll^Fp, Gll^Es, Gll^Fp, Gll^Fp, Gll^Fp, Gg, Gll^Fp, Gll^Fp, Gll^Fp, Gll^Fp, Gll^Fp, Gg, Gll^Fp, Gll^Fp, Gll^Fp, Gg, Gg, Gll^Fp, Gll^Fp, Gll^Fp, Gll^Fp, Gll^Fp, Gll^Fdw, Gd, Gd, Gd, Gd, Gd, Gd, Gd, Gd, Gd, Gd, Re, Rd, Rd, Re^Vct, Rb^Edb, Rb^Edb, Rb, Ce, 2 Ke, Ce, Rb^Edb, Rb^Edb, Re^Vct, Qlf, Qlf, Qlf, Qlf, Qlf
Gll^Fp, Gll^Fp, Gll^Fp, Gll^Fp, Gll^Fp, Gll^Fp, Gg^Ve, Gg, Gll^Fp, Gll^Fp, Gll^Fp, Gll^Fp, Gll^Fp, Gg, Gg, Gg, Gg^Ve, Gll^Fp, Gll^Fp, Gll^Fp, Gll^Fp, Gll^Fp, Gll^Fdw, Gll^Fdw, Gll^Fdw, Gd, Gll^Fdw, Gll^Fdw, Gd, Gd, Gd, Gd, Gd, Gd, Re, Rd, Rd, Re, Rb, Rb, Rb, Ce, Ce, Ce, Rb^Edb, Rb^Edb, Rb^Edb, Rb, Qlf, Ql, Ql, Qlf
Gll^Fp, Gll^Fp, Gll^Efm, Gll^Fp, Gll^Fp, Gll^Fp, Gll^Fp, Gg, Gg, Gg, Gg, Gll^Fp, Gll^Fp, Gg, Gll^Fp, Gll^Fp, Gg, Gll^Fp, Gll^Fp, Gll^Fp, Gll^Efm, Gll^Fp, Gll^Fp, Gll^Fdw, Gll^Fp, Gd, Gll^Fdw, Gd^Fetd, Gd, Gd, Gd, Gd, Gd, Re, Re, Rd, Re, Rb, Rb^Edb, Rb^Ecf, Rb, Rb, Rb, Rb^Edb, Rb^Edb, Rb^Ecf, Rb, Rb, Qlf, Ql, Qlf, Qlf
Gll^Fp, Gll^Efm, Gll^Fp, Gll^Fp, Gll^Fp, Gll^Fp, Gll^Fp, Gll^Fp, Gll^Fp, Gll^Fp, Gll^Fp, Gg, Gg, Gg, Gll^Fp, Gll^Fp, Gll^Fp, Gll^Fp, Gll^Fp, Gll^Fp, Gll^Fp, Gll^Fp, Gll^Fp, Gll^Fp, Gd, Gd, Gd, Gd, Gd, Gd, Gll^Fdw, Gll^Fdw, Rd, Re, Re, Re, Re, Re^Vct, Rb^Edb, Rb^Edb, Rb, Re^Vct, Rb, Rb^Edb, Re^Vct, Rb^Edb, Rb, Re^Vct, Qlf, Qlf, Qlf, Qlf
Gll^Fp, Gll^Fp, Gll^Fp, Gll^Fp, Gll^Emf, Gll^Fp, Gll^Fp, Gll^Fp, Gll^Fp, Gll^Fp, Gll^Fp, Gg^Ve, Gll^Fp, Gg, Gll^Fp, Gll^Fp, Gll^Fp, Gll^Fp, Gll^Es, Gll^Fp, Gll^Fp, Gll^Fp, Gll^Fdw, Gd, Gd, Gd, Gd, Gd, Gd, Gd, Gd, Gd, Rd, Re, Re, Re, Re, Rb, Rb, Rb, Qlf, Qlf, Qlf, Qlf, Qlf, Rb, Qlf, Qlf, Ql, Ql, Qlf, Qlf
Gll^Fp, Gll^Fp, Gll^Fp, Gll^Fp, Gll^Fp, Gll^Em, Gll^Fp, Gll^Fp, Gll^Fp, Gll^Fp, Gll^Fp, Gll^Fp, Gll^Fp, Gll^Fp, Gll^Fp, Gll^Fp, Gll^Fp, Gll^Fp, Gll^Fp, Gll^Fp, Gll^Fp, Gll^Fp, Gd, Gd, Gd, Gd, Gll^Fdw, Gd, Gd, Gd, Gd, Gd, Rd, Rd, Re, Re, Re, Rb, Rb, Rb, Qlf, Qlf, Ql, Ql, Qlf, Qlf, Ql, Qlf, Qlf, Ql, Qlf, Qlf
Gll^Fp, Gll^Fp, Gll^Fp, Gll^Fp, Gll^Fp, Gll^Fp, Gll^Fp, Gll^Fp, Gll^Fp, Gll^Fp, Gll^Fp, Gll^Fp, Gll^Fp, Gll^Fp, Gll^Em, Gll^Emf, Gll^Fp, Gll^Fdw, Gll^Fp, Gll^Fdw, Gll^Fdw, Gll^Fdw, Gd, Gd, Gll^Fdw, Gll^Fdw, Gll^Fdw, Gll^Fdw, Gd, Gd, Re, Rd, Re, Re, Re, Re, Rb, Rb, Rb, Rb, Qlf, Qlf, Qlf, Ql, Qlf, Qlf, Ql, Ql, Qlf, Qlf, Qlf, Qlf
Gll^Fp, Gll^Fp, Gll^Fp, Gll^Fp, Gll^Fp, Gll^Fp, Gll^Fp, Gll^Fp, Gll^Fp, Gll^Fp, Gll^Fp, Gll^Fp, Gll^Fp, Gll^Fp, Gll^Fp, Gll^Em, Gll^Fp, Gll^Fp, Gll^Fp, Gll^Fp, Gll^Fp, Gll^Fdw, Gd, Gd, Gll^Fdw, Gll^Fdw, Gs, Gd, Gd, Re, Re, Re, Re, Re, Re, Rb, Rb, Rb, Rb, Rb, Gg, Qlf, Qlf, Qlf, Qlf, Qlf, Qlf, Qlf, Qlf, Qlf, Qlf, Qlf
