Hh, Gll^Fp, Gll^Fp, Gs^Fp, Hh, Gs^Fp, Hh, Hh, Mm, Gs^Fp, Hh^Es, Hh, Mm, Gs^Fp, Hh^Fp, Wwt, Gs^Fp, Gs^Fp, Hh^Fp, Mm, Mm, Gs^Fp, Hh^Fp, Hh^Fp, Gs^Fp, Gs^Fms, Gs^Fms, Gs^Fp, Gll^Fmw, Gs^Fp, Gs^Fp, Gs^Fp, Gs^Fp, Gs^Fp, Gs^Fp, Gs^Fp, Gll^Fmw, Gs^Fp, Gll^Fmw, Gll^Fmw, Gll^Fmw, Re, Gll^Fdw, Gs^Fp, Gs^Fp, Gs^Fp, Gll^Fmw, Gs^Fp
Hh^Es, Gll^Fp, Mm, Mm, Mm, Mm, Mm, Hh^Es, Hh^Es, Mm, Mm, Hh^Es, Mm, Mm, Hh^Fms, Wwt, Wwt, Gs^Fp, Hh^Fp, Mm, Gs^Fms, Hh^Fds, Gs^Fds, Gs^Fms, Gs^Fms, Gs^Fp, Gs^Fms, Gll^Fmw, Gll^Fmw, Gs^Fp, Gll^Fmw, Gll^Fmw, Gs^Fp, Gll^Fmw, Gs^Fmw, Gll^Fmw, Gll^Fmw, Gd^Em, Gd^Es, Gd^Fmw, Gd^Em, Gll^Fdw, Gs^Fp, Gll^Fmw, Gs^Fp, Gs^Fp, Gll^Fmw, Gll^Fmw
Hh^Es, Gll^Em, Gll^Emf, Mm, Mm, Mm, Mm^Xm, Mm^Xm, Mm^Xm, Mm, Mm, Mm, Mm, Gs^Fds, Gs^Fds, Hh^Fp, Hh^Fp, Wwt, Gs^Fp, Gs^Fp, Gs^Fp, Gs^Fms, Gg^Vl, Gs^Fp, Gg^Em, Gs^Fmw, Gs^Fp, Gll^Fmw, Gll^Fmw, Gll^Fmw, Gd^Em, Gll^Fmw, Gll^Fmw, Gs^Fp, Gd^Em, Gs^Fmw, Gll^Fmw, Gs^Vh, Gd, Gd^Es, Gll^Fdw, Gll^Fdw, Gll^Fmw, Gll^Fmw, Gll^Fmw, Gd^Fdw, Gd^Fdw, Gd^Fdw
Gs^Fms, Hh^Em, Mm, Mm, Mm, Mm^Xm, Mm^Xm, Mm^Xm, Mm^Xm, Mm, Mm, Mm, Mm, Hh^Fds, Gs^Fms, Gs^Fms, Ww^Ewf, Wwt, Gg^Efm, Gg^Em, Gg, Gs^Fp, Gg^Efm, Gg, Gg, Gs^Fmw, Gs^Em, Gs^Fp, Gs^Fp, Gll^Fmw, Gd^Em, Gll^Fdw, Gll^Fmw, Gll^Fdw, Gd^Em, Gll^Fdw, Gll^Fmw, Gll^Fmw, Gll^Fdw, Gd, Re^Es, Gll^Fmw, Re^Fdw, Re^Fdw, Gll^Fdw, Re, Re^Es, Re
Gs^Fms, Hh^Fms, Mm, Mm, Mm^Xm, Mm^Xm, Mm^Xm, Mm^Xm, Hh^Fp, Mm, Hh^Fp, Hh^Fds, Hh^Fms, Mm, Hh, Ww^Ewf, Ww^Ewf, Wwrt, Wwt, Gg^Efm, Gs^Fp, Gg^Efm, Gs^Fp, Gs^Fms, Gs, Gg^Efm, Gs^Em, Gs^Ve, Gs^Fmw, Gll^Fmw, Gll^Fdw, Gd, Re^Es, Gll^Fdw, Gd, Gd^Fdw, Gd, Gll^Fdw, Re, Gd^Em, Re, Gd^Fdw, Re, Re, Rb^Es, Re, Re, Re
Gs^Fp, Hh^Fds, Hh^Fds, Mm, Mm, Mm^Xm, Mm, Mm, Hh^Fms, Hh^Fms, Hh^Fp, Gs^Fms, Gs^Fms, Hh^Fp, Hh, Wwt, Wwrt, Ww^Ewf, Wwt, Gg, Gs^Fms, Gs^Fp, Gs^Fms, Gs^Fp, Gs^Fms, Gs, Gs^Fp, Gs^Fp, Gs^Fmw, Gs^Fmw, Gd^Fdw, Gd^Es, Re^Es, Gd, Gd^Em, Re, Re, Re, Re, Re^Es, Rd, Re, Re, Rb^Es, Rb^Edb, Rb^Edb, Rb^Edb, Rb
Gs^Fp, Mm, Mm, Mm, Mm, Mm^Xm, Mm, Hh^Fms, Gs^Fds, Gs^Fds, Gs^Fms, Gs^Fms, Hh^Fds, Gs^Fp, Hh^Fp, Gs^Fp, Gg^Efm, Wwrt, Gs^Fp, Gs^Fp, Gs^Fds, Gs^Fds, Gs^Fms, Gs^Fms, Gs^Fmw, Gs^Fp, Gs^Fmw, Gs^Fp, Gll^Fmw, Gd^Fmw, Gd, Gd, Gd, Gd, Gll^Fdw, Gll^Fdw, Re, Gd, Gll^Fdw, Re, Rd^Esd, Rd^Esd, Re, Rb, Qlf, Qlf, Qlf, Qlf
Gs^Fp, Hh^Fds, Hh^Fp, Mm, Hh^Fp, Mm, Mm, Hh^Fms, Gs^Fds, Gg^Fet, Gs^Fms, Hh^Fds, Hh^Fp, Gs^Fms, Gs^Fds, Gs^Fms, Gs^Em, Gg^Efm, Gs^Emf, Gs^Fms, Gs^Fp, Gs^Fms, Gg^Em, Gs^Fms, Gs^Fms, Gll^Em, Gs^Emf, Gs^Fmw, Gll^Fdw, Gll^Fdw, Re^Es, Gd^Fdw, Gll^Fdw, Gd, Re, Gd^Em, Re, Re, Re, Gd^Em, Re, Re, Rb, Rb^Edb, Qlf, Qlf, Qlf, Qlf
Hh, Mm, Mm, Hh^Fp, Hh^Emf, Hh^Em, Hh^Fp, Hh^Fp, Hh^Fms, Gs^Fp, Gs^Fds, Gs^Fms, Gs^Fms, Gs^Em, Gs^Fms, Gs^Fp, Gs^Fp, Gg, Gs^Em, Gs^Fms, Gs^Fp, Gg^Em, Gg^Vc, Gs^Fp, Gll^Fmw, Gs^Fp, Gll^Fmw, Gll^Fmw, Gd^Em, Gd^Fdw, Re^Es, Gd^Fdw, Gd^Em, Gd, Re^Edb, Re^Edb, Rd^Edb, Rd^Esd, Rd, Gll^Fdw, Gll^Fdw, Re, Rb, Qlf, Qlf, Ql, Ql, Qlf
Gs^Fp, Hh^Fms, Mm, Mm, Mm, Mm, Hh^Fp, Hh^Fp, Mm, Hh^Fds, Gs^Fms, Gs^Fp, Gs^Fms, Gs^Efm, Gs^Fms, Gs^Fp, Gg^Efm, Gg, Gs^Em, Gs^Fp, Gs^Em, Gg, Gs^Fp, Gs^Fp, Gll^Fmw, Gs^Fp, Gll^Fmw, Gll^Fdw, Gd^Em, Gd, Gd^Fdw, Re, Gd, Gd^Es, Re, Re^Edb, Re^Edb, Re^Edb, Rd, Rd^Esd, Rb, Rb, Qlf, Qlf, Qlf, Ql, Qlf, Qlf
Hh^Fp, Hh^Fms, Hh^Fms, Mm, Mm, Mm, Hh^Fp, Hh^Em, Hh^Em, Hh^Fms, Gs^Fms, Gs^Fp, Gs^Fp, Gs^Fp, Gs^Fp, Gs^Em, Gs^Em, Gs^Fp, 1 Kv, Cv, Gg, Gs^Fp, Gs^Fp, Gs^Fp, Gs^Em, Gll^Fmw, Gll^Fmw, Gll^Fmw, Gd^Fdw, Gd^Em, Gd, Gd, Gll^Fdw, Re, Rd^Esd, Re, Re, Rd, Re, Rd^Esd, Rd, Rb^Edb, Rb^Edb, Rb^Edb, Rb, Qlf, Qlf, Qlf
Hh^Fds, Hh^Fds, Hh^Fp, Mm, Mm, Hh^Fmw, Gll^Em, Gs^Fp, Gs^Fp, Gs^Fp, Gs^Fp, Gll^Emf, Gs^Fms, Gs^Fp, Gs^Fms, Gg^Efm, Gg^Efm, Gs^Fp, Cv, Cv, Gs^Fp, Gs^Fp, Gs^Fp, Gs^Emf, Gll^Fmw, Gll^Fmw, Gll^Fmw, Gll^Fdw, Gll^Fmw, Gd^Fdw, Gd^Em, Re, Rd, Gll^Fdw, Re, Rd, Re^Es, Re^Es, Rb^Es, Re, Rb^Vct, Qlf, Qlf, Qlf, Qlf, Qlf, Qlf, Qlf
Gs^Fms, Gs^Fds, Hh^Fp, Hh^Fmw, Hh^Em, Hh^Fmw, Hh^Es, Gll^Fmw, Hh^Fmw, Hh^Fmw, Gll^Fmw, Gll^Em, Gs^Fp, Gs^Fms, Gs^Fds, Gs^Fp, Gs^Fp, Gg, Gg, Gg^Efm, Gg^Efm, Gs^Fp, Gs^Fp, Gs^Fp, Gll^Fmw, Gll^Fp, Gll^Fmw, Gll^Fdw, Gd^Em, Gll^Fdw, Re^Es, Re^Es, Rd^Esd, Re, Re^Es, Re^Vct, Rb^Edb, Rb, Rb^Ecf, Rb, Rb^Edb, Rb, Qlf, Qlf, Ql, Qlf, Qlf, Qlf
Hh^Fp, Hh^Fms, Hh^Fp, Gll^Emf, Gll^Em, Gs^Fp, Hh^Es, Gll^Es, Gll^Fmw, Gll^Fp, Gll^Fp, Gs^Fp, Gg^Vl, Gs^Fds, Gs^Fms, Gs^Fms, Gs^Fp, Gs^Em, Gg, Gg, Gs^Ve, Gs, Gs^Fp, Gs^Fmw, Gd^Fmw, Gll^Fmw, Gll^Fdw, Gd^Em, Gll^Fdw, Gd, Re, Re, Re, Re^Es, Re^Es, Rb, Rb^Edb, Rb^Edb, Rb, Rb, Rb, Rb, Qlf, Qlf, Ql, Ql, Qlf, Qlf
Hh^Fp, Hh^Fp, Gs^Fds, Gll^Em, Gs^Fp, Hh^Fp, Gs^Fp, Gs^Em, Gll^Emf, Gll^Fp, Gll^Fp, Gg, Gs^Em, Gs^Fp, Gs^Fms, Gs^Fms, Gs^Efm, Gs^Fp, Gs, Gg^Efm, Gs^Em, Gll^Fmw, Gll^Fmw, Gd^Fmw, Gd^Em, Gll^Fdw, Gd^Em, Gll^Fdw, Re, Re^Es, Re^Es, Rd, Rd, Rd, Rb^Edb, Rb^Edb, Rb, Rb^Edb, Ce, Rb, Rb^Edb, Qlf, Rb, Qlf, Qlf, Qlf, Qlf, Qlf
Mm, Hh^Fms, Gs^Em, Gs^Fp, Gs^Fms, Hh^Fp, Gs^Efm, Gs, Gs^Fp, Hh^Fp, Hh^Fp, Gs^Fms, Gs^Em, Gs^Fp, Gs^Fp, Gs^Fms, Gg, Gs, Gs^Fms, Gs^Fms, Gs^Fp, Gll^Fmw, Gd^Fmw, Gd^Fdw, Gd^Em, Re, Re^Es, Gd, Gd, Gd^Fdw, Re, Rd^Esd, Rd^Esd, Re, Rb^Edb, Rb^Edb, Rb, Ce, 2 Ke, Ce, Rb^Edb, Rb^Edb, Rb^Vct, Rb, Qlf, Qlf, Qlf, Qlf
Mm, Mm, Hh^Fp, Gs^Fp, Hh^Fms, Gs^Fp, Gg^Vc, Gg, Gs^Fp, Gs^Fp, Gs^Fp, Gs^Fms, Gs^Fms, Gs, Gs, Gg^Efm, Gg^Vh, Gs^Fp, Gs^Fms, Gs^Fp, Gll^Fmw, Gll^Fmw, Gll^Fdw, Gll^Fdw, Gll^Fdw, Re^Es, Gll^Fmw, Gd^Fdw, Gd^Em, Gd, Re, Re, Rd^Esd, Rd, Rd, Re, Rb, Ce, Ce, Ce, Rb^Edb, Rb^Edb, Rb^Edb, Qlf, Ql, Ql, Qlf, Qlf
Hh^Fp, Hh^Fp, Gg^Efm, Hh^Fms, Gs^Fds, Gs^Fds, Gs^Fp, Gg, Gg^Efm, Gg^Efm, Gg, Gs^Fms, Gs^Fp, Gs, Gs^Fp, Gs^Fp, Gg^Efm, Gs^Fp, Gs^Fp, Gs^Fmw, Gll^Efm, Gll^Fmw, Gd^Fmw, Gd^Fmw, Gll^Fdw, Re^Es, Gd^Fdw, Re^Fdw, Re, Re, Re^Es, Rd, Re, Re, Re, Rb^Ecf, Rb, Rb, Rb, Rb^Edb, Rb^Edb, Rb^Ecf, Rb, Qlf, Qlf, Ql, Qlf, Qlf
Gs^Fp, Hh^Fms, Gs^Fms, Gs^Efm, Ww^Ewf, Ww^Ewf, Wwrt, Wwt, Gs^Fp, Gs^Fp, Gs^Fp, Gg^Em, Gs, Gs^Em, Gs^Fms, Gs^Fp, Gs^Fms, Gs^Fp, Gs^Fp, Gs^Fp, Gll^Fmw, Gll^Fmw, Gll^Fmw, Gd^Fdw, Gd, Gd, Gd^Em, Re^Es, Rd, Re^Es, Re, Re, Re^Edb, Re^Vct, Rb^Edb, Rb^Edb, Rb, Rb^Es, Rb^Es, Rb^Edb, Rb^Vct, Rb^Edb, Rb, Rb^Vct, Qlf, Qlf, Qlf, Qlf
Gs^Fds, Hh^Fds, Gs^Em, Gs^Fp, Wwrt, Ww^Ewf, Wwrt, Wwt, Ww^Ewf, Gg^Fp, Gs^Fp, Gg^Ve, Gs^Fp, Gs^Emf, Gs^Fms, Gs^Fms, Gs^Fms, Gs^Fp, Gll^Em, Gll^Fmw, Gll^Fmw, Gd^Em, Gll^Fdw, Gd^Em, Re, Gll^Fdw, Re, Re^Es, Re, Rd^Esd, Re, Re^Edb, Re^Edb, Rb, Rb^Edb, Rb^Edb, Qlf, Qlf, Qlf, Qlf, Qlf, Rb, Qlf, Qlf, Ql, Qlf, Qlf, Qlf
Gs^Fp, Hh^Fds, Gs^Fms, Ww^Ewf, Ww^Ewf, Wwt, Gg^Efm, Ww^Ewf, Wwt, Gg^Fp, Gg^Fp, Gs^Fp, Gs^Fp, Gs^Fp, Gs^Fms, Gs^Fds, Gs^Fds, Gs^Fms, Gll^Fmw, Gll^Fmw, Gd^Em, Gd, Re^Es, Gd^Em, Gd^Fdw, Re^Es, Gll^Fdw, Gd^Fdw, Re, Rd, Rd^Esd, Re, Re^Edb, Rb^Edb, Qlf, Rb, Qlf, Qlf, Ql, Ql, Qlf, Qlf, Qlf, Qlf, Ql, Ql, Qlf, Qlf
Gs^Fp, Gs^Fms, Gs^Efm, Gs^Efm, Wwrt, Wwrt, Gg^Efm, Gg, Gg, Wwrt, Wwrt, Wwt, Wwt, Gs^Fp, Gll^Em, Gs^Fms, Gs^Fp, Gs^Fms, Gs^Fmw, Gll^Fdw, Gll^Fmw, Gd^Fdw, Gd^Fdw, Re^Es, Gll^Fdw, Gd^Em, Re, Rd, Re^Es, Rd^Es, Re, Re, Rb, Rb, Qlf, Qlf, Qlf, Qlf, Qlf, Ql, Qlf, Qlf, Qlf, Qlf, Qlf, Qlf, Qlf, Qlf
Gs^Fp, Gs^Fp, Wwt, Wwt, Gs^Fp, Gg, Gs^Fp, Gs^Fp, Gs^Fp, Gs^Fp, Gs^Fp, Gs^Fp, Gs^Fp, Wwt, Gs^Fp, Gll^Em, Gs^Fp, Gs^Fp, Gs^Fp, Gll^Fdw, Gll^Fdw, Gd^Fdw, Gd, Gd^Em, Gll^Fdw, Re, Re, Re, Re, Re, Re, Rb, Rb, Qlf, Qlf, Qlf, Qlf, Qlf, Qlf, Qlf, Qlf, Qlf, Qlf, Qlf, Qlf, Qlf, Qlf, Qlf
