Hh, Gll^Fp, Gll^Fp, Gs^Fp, Hh, Gs^Fp, Hh, Hh, Mm, Gs^Fp, Hh^Es, Hh, Mm, Gs^Fp, Hh^Fp, Wwt, Gs^Fp, Gs^Fp, Hh^Fp, Mm, Mm, Gs^Fp, Hh^Fp, Hh^Fp, Gs^Fp, Gs^Fms, Gs^Fms, Gs^Fp, Gs^Fp, Gs^Fp, Gs^Fp, Gs^Fp, Gs^Fp, Gs^Fp, Gs^Fp, Gs^Fp, Gs^Fp, Gs^Fp, Gs^Fp, Gs^Fp, Re, Re, Gs^Fp, Gs^Fp, Gs^Fp, Gs^Fp, Gs^Fp, Gs^Fp
Hh^Es, Gll^Fp, Mm, Mm, Mm, Mm, Mm, Hh^Es, Hh^Es, Mm, Mm, Hh^Es, Mm, Mm, Hh^Fms, Wwt, Wwt, Gs^Fp, Hh^Fp, Mm, Gs^Fms, Hh^Fds, Gs^Fds, Gs^Fms, Gs^Fms, Gs^Fp, Gs^Fms, Gs^Fp, Gs^Fp, Gs^Fp, Gll^Fdw, Gs^Fp, Gs^Fp, Gs^Fp, Gs^Fp, Gs^Fp, Gs^Fp, Gs^Fp, Gs^Fp, Gs^Fp, Gs^Fp, Gs^Fp, Gs^Fp, Gs^Fp, Gs^Fp, Gs^Fp, Gs^Fp, Gs^Fp
Hh^Es, Gll^Em, Gll^Emf, Mm, Mm, Mm, Mm^Xm, Mm^Xm, Mm^Xm, Mm, Mm, Mm, Mm, Gs^Fds, Gs^Fds, Hh^Fp, Hh^Fp, Wwt, Gs^Fp, Gs^Fp, Gs^Fp, Gs^Fms, Gg^Ve, Gs^Fp, Gg, Gs^Fp, Gs^Fp, Gs^Fp, Gs^Fp, Gs^Fp, Gd, Gs^Fp, Gll^Fdw, Gs^Fp, Gd, Gs^Fp, Gs^Fp, Gg^Ve, Gs^Fp, Gs^Fp, Gs^Fp, Gs^Fp, Gs^Fp, Gs^Fp, Gs^Fp, Gs^Fp, Gs^Fp, Gs^Fp
Gs^Fms, Hh^Em, Mm, Mm, Mm, Mm^Xm, Mm^Xm, Mm^Xm, Mm^Xm, Mm, Mm, Mm, Mm, Hh^Fds, Gs^Fms, Gs^Fms, Ww^Ewf, Wwt, Gg^Efm, Gg, Gg, Gs^Fp, Gg, Gg, Gg, Gs^Fp, Gg, Gs^Fp, Gs^Fp, Gs^Fp, Gd, Gll^Fdw, Gll^Fdw, Gll^Fdw, Gd, Gs^Fp, Gs^Fp, Gs^Fp, Gll^Fdw, Gll^Fdw, Gd, Gs^Fp, Gs^Fp, Gs^Fp, Gs^Fp, Gs^Fp, Re, Re
Gs^Fms, Hh^Fms, Mm, Mm, Mm^Xm, Mm^Xm, Mm^Xm, Mm^Xm, Hh^Fp, Mm, Hh^Fp, Hh^Fds, Hh^Fms, Mm, Hh, Ww^Ewf, Ww^Ewf, Wwrt, Wwt, Gg^Efm, Gs^Fp, Gg, Gs^Fp, Gs^Fms, Gg, Gg^Efm, Gg, Gg^Ve, Gs^Fp, Gs^Fp, Gs^Fp, Gd, Gd, Gll^Fdw, Gd, Gs^Fp, Gd, Gll^Fdw, Gd, Gd, Gd, Gll^Fdw, Gs^Fp, Gs^Fp, Re, Re, Re, Re
Gs^Fp, Hh^Fds, Hh^Fds, Mm, Mm, Mm^Xm, Mm, Mm, Hh^Fms, Hh^Fms, Hh^Fp, Gs^Fms, Gs^Fms, Hh^Fp, Hh, Wwt, Wwrt, Ww^Ewf, Wwt, Gg, Gs^Fms, Gs^Fp, Gs^Fms, Gs^Fp, Gs^Fms, Gg, Gs^Fp, Gs^Fp, Gs^Fp, Gs^Fp, Gll^Fdw, Gd, Gd, Gd, Gd, Gd, Gd, Gd, Gd, Gd, Gd, Gd, Gd, Re, Re, Re, Re, Re
Gs^Fp, Mm, Mm, Mm, Mm, Mm^Xm, Mm, Hh^Fms, Gs^Fds, Gs^Fds, Gs^Fms, Gs^Fms, Hh^Fds, Gs^Fp, Hh^Fp, Gs^Fp, Gg^Efm, Wwrt, Gs^Fp, Gs^Fp, Gs^Fds, Gs^Fds, Gs^Fms, Gs^Fms, Gs^Fp, Gs^Fp, Gs^Fp, Gs^Fp, Gs^Fp, Gs^Fp, Gd, Gd, Gd, Gd, Gll^Fdw, Gll^Fdw, Gd, Gd, Gd^Fetd, Gd, Gd, Gd, Re, Re, Qlf, Qlf, Qlf, Qlf
Gs^Fp, Hh^Fds, Hh^Fp, Mm, Hh^Fp, Mm, Mm, Hh^Fms, Gs^Fds, Gg^Fet, Gs^Fms, Hh^Fds, Hh^Fp, Gs^Fms, Gs^Fds, Gs^Fms, Gs^Em, Gg^Efm, Gs^Emf, Gs^Fms, Gs^Fp, Gs^Fms, Gg^Em, Gs^Fms, Gs^Fms, Gll^Es, Gs^Fp, Gs^Fp, Gs^Fp, Gll^Fdw, Gd, Gd, Gd, Gd, Gd, Gd, Gd, Gd, Gd, Gd, Gd, Gd, Re, Re, Qlf, Qlf, Qlf, Qlf
Hh, Mm, Mm, Hh^Fp, Hh^Emf, Hh^Em, Hh^Fp, Hh^Fp, Hh^Fms, Gs^Fp, Gs^Fds, Gs^Fms, Gs^Fms, Gs^Em, Gs^Fms, Gs^Fp, Gs^Fp, Gg, Gs^Em, Gs^Fms, Gs^Fp, Gg^Em, Gg^Ve, Gs^Fp, Gs^Fp, Gs^Fp, Gs^Fp, Gs^Fp, Gd, Gll^Fdw, Gd, Gd, Gd, Gd, Gd, Gd, Rd, Rd, Rd, Gll^Fdw, Gll^Fdw, Re, Re, Qlf, Qlf, Ql, Ql, Qlf
Gs^Fp, Hh^Fms, Mm, Mm, Mm, Mm, Hh^Fp, Hh^Fp, Mm, Hh^Fds, Gs^Fms, Gs^Fp, Gs^Fms, Gs^Efm, Gs^Fms, Gs^Fp, Gg^Efm, Gg, Gs^Em, Gs^Fp, Gs^Em, Gg, Gs^Fp, Gs^Fp, Gs^Fp, Gs^Fp, Gs^Fp, Gs^Fp, Gd, Gd, Gd, Gd^Fetd, Gd, Gd, Re, Re, Re, Re, Rd, Rd, Re, Re, Qlf, Qlf, Qlf, Ql, Qlf, Qlf
Hh^Fp, Hh^Fms, Hh^Fms, Mm, Mm, Mm, Hh^Fp, Hh^Em, Hh^Em, Hh^Fms, Gs^Fms, Gs^Fp, Gs^Fp, Gs^Fp, Gs^Fp, Gs^Em, Gs^Em, Gs^Fp, 1 Kv, Cv, Gg, Gs^Fp, Gs^Fp, Gs^Fp, Gll^Es, Gs^Fp, Gs^Fp, Gs^Fp, Gll^Fdw, Gd, Gd, Gd, Gll^Fdw, Re, Re, Re, Re, Re, Re, Rd, Rd, Re, Rb, Rb, Rb, Qlf, Qlf, Qlf
Hh^Fds, Hh^Fds, Hh^Fp, Mm, Mm, Hh^Fmw, Gll^Em, Gs^Fp, Gs^Fp, Gs^Fp, Gs^Fp, Gll^Emf, Gs^Fms, Gs^Fp, Gs^Fms, Gg^Efm, Gg^Efm, Gs^Fp, Cv, Cv, Gs^Fp, Gs^Fp, Gs^Fp, Gll^Es, Gs^Fp, Gs^Fp, Gs^Fp, Gll^Fdw, Gll^Fdw, Gll^Fdw, Gd, Re, Re, Gll^Fdw, Re, Re, Re, Re, Rb, Re, Re^Vct, Qlf, Qlf, Qlf, Qlf, Qlf, Qlf, Qlf
Gs^Fms, Gs^Fds, Hh^Fp, Hh^Fmw, Hh^Em, Hh^Fmw, Hh^Es, Gll^Fmw, Hh^Fmw, Hh^Fmw, Gll^Fmw, Gll^Em, Gs^Fp, Gs^Fms, Gs^Fds, Gs^Fp, Gs^Fp, Gg, Gg, Gg^Efm, Gg^Efm, Gs^Fp, Gs^Fp, Gs^Fp, Gs^Fp, Gs^Fp, Gs^Fp, Gs^Fp, Gs^Fp, Gs^Fp, Gd, Re, Re, Re, Re, Re^Vct, Rb, Rb, Rb^Ecf, Rb, Rb^Edb, Rb, Qlf, Qlf, Ql, Qlf, Qlf, Qlf
Hh^Fp, Hh^Fms, Hh^Fp, Gll^Emf, Gll^Em, Gs^Fp, Hh^Es, Gll^Es, Gll^Fmw, Gll^Fp, Gll^Fp, Gs^Fp, Gg^Ve, Gs^Fds, Gs^Fms, Gs^Fms, Gs^Fp, Gs^Em, Gg, Gg, Gg^Ve, Gg, Gs^Fp, Gs^Fp, Gs^Fp, Gs^Fp, Gll^Fdw, Gs^Fp, Gs^Fp, Gd, Rd, Rd, Re, Re, Re, Rb, Rb^Edb, Rb, Rb, Rb, Re^Vct, Rb, Qlf, Qlf, Ql, Ql, Qlf, Qlf
Hh^Fp, Hh^Fp, Gs^Fds, Gll^Em, Gs^Fp, Hh^Fp, Gs^Fp, Gs^Em, Gll^Emf, Gll^Fp, Gll^Fp, Gg, Gs^Em, Gs^Fp, Gs^Fms, Gs^Fms, Gs^Efm, Gs^Fp, Gs, Gg^Efm, Gs^Em, Gs^Fp, Gs^Fp, Gs^Fp, Gd, Gll^Fdw, Gd, Gll^Fdw, Gd, Gd, Rd, Rd, Re, Re, Rb^Edb, Rb, Rb, Rb, Ce, Rb, Rb^Edb, Qlf, Rb, Qlf, Qlf, Qlf, Qlf, Qlf
Mm, Hh^Fms, Gs^Em, Gs^Fp, Gs^Fms, Hh^Fp, Gs^Efm, Gs, Gs^Fp, Hh^Fp, Hh^Fp, Gs^Fms, Gs^Em, Gs^Fp, Gs^Fp, Gs^Fms, Gg, Gs, Gs^Fp, Gs^Fp, Gs^Fp, Gs^Fp, Gs^Fp, Gll^Fdw, Gd, Gd, Gd, Gd, Gd, Gd, Re, Rd, Rd, Re^Vct, Rb^Edb, Rb^Edb, Rb, Ce, 2 Ke, Ce, Rb^Edb, Rb^Edb, Re^Vct, Rb, Qlf, Qlf, Qlf, Qlf
Mm, Mm, Hh^Fp, Gs^Fp, Hh^Fms, Gs^Fp, Gg^Ve, Gg, Gs^Fp, Gs^Fp, Gs^Fp, Gs^Fms, Gs^Fms, Gs, Gs, Gg^Efm, Gg^Ve, Gs^Fp, Gs^Fp, Gs^Fp, Gs^Fp, Gs^Fp, Gll^Fdw, Gll^Fdw, Gll^Fdw, Gd, Gll^Fdw, Gll^Fdw, Gd, Gd, Re, Rd, Rd, Re, Rb, Rb, Rb, Ce, Ce, Ce, Rb^Edb, Rb^Edb, Rb^Edb, Qlf, Ql, Ql, Qlf, Qlf
Hh^Fp, Hh^Fp, Gg^Efm, Hh^Fms, Gs^Fds, Gs^Fds, Gs^Fp, Gg, Gg^Efm, Gg^Efm, Gg, Gs^Fms, Gs^Fp, Gs, Gs^Fp, Gs^Fp, Gg^Efm, Gs^Fp, Gs^Fp, Gs^Fp, Gll^Efm, Gs^Fp, Gs^Fp, Gll^Fdw, Gs^Fp, Gd, Gll^Fdw, Gd^Fetd, Gd, Re, Re, Rd, Re, Rb, Rb^Edb, Rb^Ecf, Rb, Rb, Rb, Rb^Edb, Rb^Edb, Rb^Ecf, Rb, Qlf, Qlf, Ql, Qlf, Qlf
Gs^Fp, Hh^Fms, Gs^Fms, Gs^Efm, Ww^Ewf, Ww^Ewf, Wwrt, Wwt, Gs^Fp, Gs^Fp, Gs^Fp, Gg^Em, Gs, Gs^Em, Gs^Fms, Gs^Fp, Gs^Fms, Gs^Fp, Gs^Fp, Gs^Fp, Gs^Fp, Gs^Fp, Gs^Fp, Gs^Fp, Gd, Gd, Gd, Gd, Rd, Re, Re, Re, Re, Re^Vct, Rb^Edb, Rb^Edb, Rb, Re^Vct, Rb, Rb^Edb, Re^Vct, Rb^Edb, Rb, Re^Vct, Qlf, Qlf, Qlf, Qlf
Gs^Fds, Hh^Fds, Gs^Em, Gs^Fp, Wwrt, Ww^Ewf, Wwrt, Wwt, Ww^Ewf, Gg^Fp, Gs^Fp, Gg^Ve, Gs^Fp, Gs^Emf, Gs^Fms, Gs^Fms, Gs^Fms, Gs^Fp, Gll^Es, Gs^Fp, Gs^Fp, Gs^Fp, Gll^Fdw, Gd, Gd, Gd, Gd, Gd, Rd, Re, Re, Re, Re, Rb, Rb, Rb, Qlf, Qlf, Qlf, Qlf, Qlf, Rb, Qlf, Qlf, Ql, Qlf, Qlf, Qlf
Gs^Fp, Hh^Fds, Gs^Fms, Ww^Ewf, Ww^Ewf, Wwt, Gg^Efm, Ww^Ewf, Wwt, Gg^Fp, Gg^Fp, Gs^Fp, Gs^Fp, Gs^Fp, Gs^Fms, Gs^Fds, Gs^Fds, Gs^Fms, Gs^Fp, Gs^Fp, Gs^Fp, Gs^Fp, Gd, Gd, Gd, Gd, Gd, Gd, Rd, Rd, Re, Re, Re, Rb, Qlf, Rb, Qlf, Qlf, Ql, Ql, Qlf, Qlf, Qlf, Qlf, Ql, Ql, Qlf, Qlf
Gs^Fp, Gs^Fms, Gs^Efm, Gs^Efm, Wwrt, Wwrt, Gg^Efm, Gg, Gg, Wwrt, Wwrt, Wwt, Wwt, Gs^Fp, Gll^Em, Gs^Fms, Gs^Fp, Gs^Fms, Gs^Fms, Gll^Fdw, Gll^Fdw, Gll^Fdw, Gd, Gd, Gll^Fdw, Gd, Re, Rd, Re, Re, Re, Re, Rb, Rb, Qlf, Qlf, Qlf, Qlf, Qlf, Ql, Qlf, Qlf, Qlf, Qlf, Qlf, Qlf, Qlf, Qlf
Gs^Fp, Gs^Fp, Wwt, Wwt, Gs^Fp, Gg, Gs^Fp, Gs^Fp, Gs^Fp, Gs^Fp, Gs^Fp, Gs^Fp, Gs^Fp, Wwt, Gs^Fp, Gll^Em, Gs^Fp, Gs^Fp, Gs^Fp, Gs^Fp, Gs^Fp, Gll^Fdw, Gd, Gd, Gll^Fdw, Re, Re, Re, Re, Re, Re, Rb, Rb, Qlf, Qlf, Qlf, Qlf, Qlf, Qlf, Qlf, Qlf, Qlf, Qlf, Qlf, Qlf, Qlf, Qlf, Qlf
