Mm^Xm, Mm^Xm, Mm^Xm, Mm^Xm, Mm^Xm, Mm^Xm, Mm, Mm, Hh, Mm, Hh, Mm, Hh^Fdw, Hh, Hh^Fmw, Hh^Fmw, Hh^Fmw, Gd, Gd^Es, Gd, Gs^Em, Gs, Gg^Es, Gg^Efm, Gs^Em, Gg, Gg^Es, Gg, Gg, Gg, Gs^Fp, Gs^Em, Gs^Fdw, Gs
Mm^Xm, Mm^Xm, Mm^Xm, Mm^Xm, Mm^Xm, Mm, Mm, Hh^Fdw, Mm, Hh^Es, Hh^Es, Hh^Fmw, Hh^Fmw, Mm, Mm, Hh^Fmw, Gd^Fdw, Gd^Fdw, Gd^Es, Gd^Fdw, Gs^Es, Gs, Gg^Efm, Gs, Gs^Em, Gs^Fmw, Re^Vwm, Re^Gvs, Re^Gvs, Gs^Fmw, Gs^Fp, Gs^Em, Gs^Efm, Gs
Mm^Xm, Mm^Xm, Mm^Xm, Mm^Xm, Mm, Mm, Mm, Mm, Hh^Fdw, Hh^Fdw, Mm, Mm, Hh^Es, Mm, Hh, Hh^Fmw, Hh^Es, Hh, Mm, Hh^Em, Gs^Es, Gs^Vc, Gg, Gs^Fp, Gg^Efm, Gs^Fp, Gg^Es, Re^Gvs, Gs, Gs, Gs, Gs, Gll^Fmw, Gs^Em
Mm^Xm, Mm^Xm, Mm^Xm, Mm^Xm, Mm, Mm, Mm, Mm, Mm, Hh^Es, Hh^Fdw, Hh^Es, Mm, Hh^Fdw, Mm, Hh^Fdw, Hh^Em, Mm, Mm, Hh^Fmw, Gd^Fdw, Gd^Es, Gs^Em, Gs, Gs^Fdw, Gg^Efm, Gg, Gg, Gs, Gs^Efm, Gs^Es, Gs^Vh, Gll^Fmw, Gs^Em
Mm^Xm, Mm^Xm, Mm^Xm, Mm^Xm, Mm^Xm, Mm, Mm, Mm, Mm, Mm, Mm, Mm, Hh^Es, Hh^Fmw, Mm, Mm, Mm, Hh^Fdw, Hh^Fmw, Hh^Fmw, Hh^Es, Hh^Fdw, Gs^Fmw, Gs^Fmw, Hh^Fp, Gs, Gg^Em, Gs^Fp, Gs, Gs, Gll^Em, Gll^Fmw, Gll^Fmw, Gll^Fmw
Mm^Xm, Mm^Xm, Mm^Xm, Mm^Xm, Mm^Xm, Mm^Xm, Mm^Xm, Mm, Mm, Mm, Mm, Mm, Hh^Fdw, Hh^Es, Hh^Es, Hh^Fmw, Hh^Em, Mm, Hh^Fdw, Mm, Hh^Es, Hh^Fp, Gs^Vl, Gs^Fp, Gs^Fmw, Hh^Fp, Gg^Efm, Gg^Em, Gs^Vh, Gs, Gll^Fmw, Gs^Fp, Gll^Fdw, Gll^Em
Mm^Xm, Mm^Xm, Mm^Xm, Mm^Xm, Mm, Mm^Xm, Mm^Xm, Mm^Xm, Mm^Xm, Mm, Mm, Mm, Mm, Hh^Es, Mm, Hh^Es, Mm, Hh^Fdw, Mm, Hh^Fmw, Hh^Fmw, Hh^Em, Hh^Fmw, Hh^Fp, Hh^Em, Gs^Fp, Gs^Fmw, Gg^Efm, Gs^Fp, Gs^Em, Gs^Em, Gs^Fp, Gll^Fmw, Gll^Fp
Mm^Xm, Mm^Xm, Mm^Xm, Mm^Xm, Mm^Xm, Mm^Xm, Mm^Xm, Mm^Xm, Mm^Xm, Mm^Xm, Mm, Mm, Mm, Mm, Mm, Mm, Mm, Mm, Mm, Mm, Mm, Hh^Es, Hh^Fmw, Hh^Fmw, Mm, Hh^Em, Gs^Fms, Gs^Fmw, Hh^Fp, Gs^Fmw, Gll^Emf, Gs^Vl, Gll^Fmw, Gll^Fdw
Mm^Xm, Mm^Xm, Mm^Xm, Mm^Xm, Mm^Xm, Mm^Xm, Mm^Xm, Mm^Xm, Mm^Xm, Mm^Xm, Mm^Xm, Mm^Xm, Mm^Xm, Mm^Xm, Mm^Xm, Mm^Xm, Mm, Mm, Mm, Mm, Mm, Hh^Fdw, Hh, Hh^Fp, Mm, Gs^Fp, Hh^Es, Gs^Fp, Gs^Fms, Gs^Fp, Hh^Fp, Gs^Fp, Gs^Fp, Gs^Fp
Mm^Xm, Mm^Xm, Mm^Xm, Mm^Xm, Mm^Xm, Mm^Xm, Mm^Xm, Mm^Xm, Mm^Xm, Mm^Xm, Mm^Xm, Mm^Xm, Mm^Xm, Mm^Xm, Mm^Xm, Mm^Xm, Mm^Xm, Mm, Mm, Mm, Mm, Hh^Fdw, Hh^Es, Hh^Fmw, Hh, Mm, Hh^Fp, Gs^Fms, Gs^Fp, Hh^Fp, Hh^Fp, Gs^Fp, Gs^Fms, Gs^Fp
Ms^Xm, Mm^Xm, Mm^Xm, Mm^Xm, Mm^Xm, Mm^Xm, Mm^Xm, Mm^Xm, Mm^Xm, Mm^Xm, Mm^Xm, Mm^Xm, Mm, Mv, Mm, Mm^Xm, Mm^Xm, Mm, Mm, Mm, Hh^Es, Hh^Es, Mm, Hh^Es, Hh^Em, Hh^Fmw, Hh^Fp, Gs^Emf, Gs^Fms, Gs^Fms, Hh^Fp, Hh^Em, Gs^Fms, Gs^Fds
Mm^Xm, Ms^Xm, Mm^Xm, Mm^Xm, Mm^Xm, Mm^Xm, Mm^Xm, Mm^Xm, Mm^Xm, Mm^Xm, Mm, Mv, Mm, Mm, Mm, Mv, Mm, Mm, Mm, Mm, Hh^Fdw, Hh^Es, Mm, Mm, Hh^Fmw, Hh^Fmw, Hh^Fp, Gs^Em, Gs^Fmw, Hh^Fds, Mm, Mm, Hh^Fds, Hh^Fp
Mm^Xm, Ms^Xm, Mm^Xm, Mm^Xm, Mm, Mm^Xm, Mm, Mm^Xm, Mm^Xm, Mm^Xm, Mm, Mm, Mm, Mm, Mm, Mm, Mm, Mm, Mm, Hh^Fdw, Hh^Es, Mm, Mm, Mm, Hh^Fmw, Hh^Em, Gll^Fp, Gs^Fmw, Hh, Gs^Fp, Hh^Fms, Hh^Fms, Hh^Em, Mm
Mm^Xm, Mm^Xm, Mm^Xm, Mm, Mm, Mm, Mm, Mm, Mm, Mm, Mm, Mm, Mm, Mm, Mm, Mm, Mm, Mm, Mm, Mm, Mm, Hh^Fdw, Hh, Hh^Em, Hh^Fp, Hh^Em, Gll^Fp, Hh^Fp, Gll^Fmw, Gs^Fms, Hh^Fp, Hh^Fp, Hh^Fmw, Mm
Mm^Xm, Mm^Xm, Mm^Xm, Mm, Mm, Mm, Mm, Hh^Fdw, Hh^Fmw, Mm, Mm, Mm, Mm, Mm, Mm, Mm, Mm, Hh^Fdw, Hh^Es, Hh^Es, Hh, Hh^Fmw, Gll^Em, Gll^Emf, Hh^Fp, Gll^Fmw, Gll^Em, Gll^Fmw, Gll^Fmw, Hh^Fp, Hh^Em, Hh^Fmw, Mm, Mm
Mm^Xm, Mm^Xm, Mm^Xm, Mm^Xm, Mm, Mm, Mm, Mm, Hh^Edb, Mm, Hh^Fdw, Mm, Mm, Mm, Mm, Mm, Mm, Hh, Mm, Mm, Hh^Fp, Hh^Fmw, Gll^Fp, Hh^Fdw, Mm, Mm, Hh^Fp, Gll^Fp, Hh^Fp, Hh^Fp, Hh^Em, Hh^Fmw, Mm, Mm
Mm^Xm, Mm^Xm, Mm, Mm, Hh^Fmw, Mm, Hh^Fp, Hh^Edb, Hh^Fp, Hh^Edb, Hh^Em, Hh^Fdw, Hh^Em, Mm, Hh^Fdw, Hh^Es, Hh^Fmw, Hh^Fp, Hh^Fmw, Hh^Fmw, Hh^Fp, Hh^Fmw, Gll^Fmw, Gll^Fdw, Hh^Es, Mm, Hh^Fp, Hh^Fp, Hh^Fp, Hh^Fp, Mm, Mm, Mm, Mm
Mm^Xm, Mm^Xm, Mm, Mm, Hh, Hh^Fp, Khr, Chr, Hh^Fp, Md, Md, Hh^Fmw, Hh^Fp, Hh^Fmw, Gll^Fp, Hh^Es, Hh^Fp, Hh^Fmw, Hh^Fmw, Hh, Hh, Hh^Fp, Hh^Fmw, Gll^Fmw, Gll^Fp, Gll^Em, Hh^Em, Hh^Fmw, Hh^Fdw, Hh^Fmw, Mm, Mm, Md, Mm
Mm^Xm, Mm^Xm, Mm, Mm, Mm, Hh^Fmw, Chr, Chr, Hh^Edb, Md, Hh^Fdw, Hh^Fp, Mm, Mm, Gll^Em, Gll^Em, Hh^Em, Hh^Fp, Hh^Fmw, Hh^Fmw, Hh, Mm, Mm, Hh^Fp, Hh^Fmw, Hh^Fp, Hh^Em, Hh^Fdw, Md, Md, Md, Md, Md, Md
Mm^Xm, Mm^Xm, Mm^Xm, Mm, Mm, Mm, Hh^Fmw, Hh^Edb, Hh^Fdw, Hh^Edb, Hh^Em, Hh^Fmw, Mm, Hh^Es, Hh^Fmw, Hh^Fmw, Mm, Mm, Mm, Mm, Mm, Hh, Hh, Hh^Fmw, Mm, Hh^Fmw, Mm, Md, Md, Md, Md, Md, Mm^Xm, Md
Mm^Xm, Mm^Xm, Mm^Xm, Mm, Mm, Hh^Fmw, Mm, Mm, Mm, Hh^Es, Hh^Es, Hh^Fdw, Gll^Fp, Hh, Mm, Hh^Fdw, Hh^Es, Hh^Es, Mm, Mm, Mm, Mm, Mm, Mm, Mm, Md, Mm, Md, Md, Md, Md, Md, Mm^Xm, Mm^Xm
Mm^Xm, Mm^Xm, Mm^Xm, Mm^Xm, Mm, Mm, Mm, Mm, Mm, Mm, Hh^Fdw, Hh^Fp, Gll^Fmw, Mm, Hh^Fp, Hh^Fdw, Mm, Hh, Mm, Mm, Mm, Mm, Mm, Mm, Mm, Mm, Mm^Xm, Mm, Mm^Xm, Mm, Mm, Mm^Xm, Mm^Xm, Mm^Xm
Mm^Xm, Mm^Xm, Mm^Xm, Mm^Xm, Mm^Xm, Mm^Xm, Mm^Xm, Mm, Mm, Mm, Hh^Em, Hh^Fdw, Hh^Em, Hh^Fp, Gll^Fmw, Hh^Fmw, Hh^Fdw, Mm, Hh^Fdw, Mm, Mm, Mm, Mm, Mm, Md^Xm, Md^Xm, Mm^Xm, Mm^Xm, Mm^Xm, Mm^Xm, Mm^Xm, Mm^Xm, Mm^Xm, Mm^Xm
Mm^Xm, Mm^Xm, Mm^Xm, Mm^Xm, Mm^Xm, Mm^Xm, Mv, Mm, Mm, Hh^Fdw, Hh^Es, Hh^Es, Hh^Em, Gll^Em, Gll^Emf, Hh^Fp, Hh^Fmw, Mm, Mm, Hh^Es, Mm, Mm, Mm, Md^Xm, Mv, Md^Xm, Mm^Xm, Mm^Xm, Mm^Xm, Mm^Xm, Mm^Xm, Mm^Xm, Mm^Xm, Md
Mm^Xm, Mm^Xm, Mm^Xm, Mm^Xm, Mv, Mm, Mm, Mm, Mm, Mm, Hh^Fdw, Hh^Es, Hh^Fdw, Hh^Fdw, Gll^Fmw, Hh^Fmw, Hh^Em, Hh^Es, Hh^Es, Hh, Mm, Md, Md, Mm, Mm, Mm, Mm, Mv, Mm, Mm^Xm, Mm^Xm, Mm^Xm, Mm^Xm, Md
Mm^Xm, Mm^Xm, Mm^Xm, Mm, Mm, Mm, Mm, Mm, Mm, Mm, Mm, Hh^Es, Hh^Fmw, Hh^Fp, Gs^Fp, Gs^Fmw, Hh^Em, Hh^Es, Hh^Fmw, Hh^Es, Mm, Md, Md, Md, Md, Mm, Mm, Mm, Mm^Xm, Mm^Xm, Mm^Xm, Mm^Xm, Mm^Xm, Mm^Xm
Mm^Xm, Mm^Xm, Mm^Xm, Mm^Xm, Mm, Mv, Mm, Mm, Mm, Mm, Mm, Hh^Fmw, Hh^Fp, Hh^Fms, Hh^Fms, Gs^Fp, Gs^Fms, Hh^Fp, Hh^Fp, Hh, Hh^Fdw, Mm, Hh^Fdw, Mm, Mm, Md, Mm, Mv, Mm, Mm^Xm, Mm^Xm, Mm^Xm, Mm^Xm, Mm^Xm
Mm^Xm, Mm^Xm, Mm^Xm, Mm^Xm, Mm^Xm, Mm, Mm^Xm, Mm, Mm, Mm, Mm, Hh^Es, Hh^Em, Mm, Mm, Gs^Fds, Hh^Fp, Hh^Fms, Hh^Fmw, Hh^Es, Hh^Es, Hh^Em, Hh^Fdw, Md, Mm, Md, Mm, Mm, Mm^Xm, Mm^Xm, Mm^Xm, Mm^Xm, Mm^Xm, Mm^Xm
Mm^Xm, Mm^Xm, Mm^Xm, Mm^Xm, Mm^Xm, Mm^Xm, Mm^Xm, Mm, Mm, Mm, Mm, Hh^Fdw, Hh^Fdw, Mm, Mm, Gs^Fms, Gs^Fds, Gs^Fms, Gll^Fp, Hh^Fmw, Mm, Mm, Hh, Mm, Mm, Md, Mm, Mm^Xm, Mm^Xm, Mm^Xm, Mm^Xm, Mm^Xm, Mm^Xm, Md
Mm, Mm^Xm, Mm^Xm, Mm^Xm, Mm^Xm, Mm^Xm, Mm, Mm, Mm, Mm, Mm, Mm, Hh^Es, Hh^Em, Hh^Fp, Gs^Fms, Gs^Fms, Hh^Fp, Gll^Fp, Gll^Em, Hh^Fmw, Hh^Fmw, Hh^Es, Mm, Mm, Mm, Mm, Mm, Mm, Mm^Xm, Mm^Xm, Mm^Xm, Mm^Xm, Mm^Xm
Md, Mm, Mm, Mm, Mm, Mm, Mm, Mm, Mm, Hh^Fdw, Hh^Fdw, Hh^Fdw, Hh^Fmw, Hh^Fdw, Mm, Hh^Fp, Gs^Fms, Hh^Fp, Gs^Fp, Hh^Fp, Hh^Fp, Hh^Em, Hh^Es, Hh^Fmw, Hh^Fmw, Mm, Mm, Mm, Mm, Mm, Md, Md, Md, Md
Mm, Md, Md, Mm, Hh^Fdw, Mm, Mm, Mm, Mm, Mm, Mm, Hh^Es, Hh^Fdw, Hh^Fp, Mm, Hh^Fp, Hh^Fp, Gll^Emf, Hh^Fmw, Gs^Fmw, Gs^Fmw, Hh^Fmw, Hh, Mm, Mm, Mm, Mm, Mm, Md, Md, Md, Md, Md, Md
Mm, Mm, Mm, Hh^Fdw, Hh, Mm, Mm, Mm, Mm, Mm, Mm, Hh^Es, Hh^Fp, Mm, Hh^Fp, Gs^Efm, Gs^Fmw, Gs^Fms, Hh^Fp, Hh^Fp, Gll^Fp, Hh^Fp, Hh^Fmw, Hh^Em, Hh^Fmw, Mm, Hh^Fdw, Mm, Md, Md, Md, Md, Md, Md
Mm, Mm, Mm, Mm, Mm, Mm, Mm, Mm, Mm, Mm, Mm, Mm, Mm, Hh^Fmw, Hh^Fp, Gs^Em, Gll^Em, Gs^Fp, Gll^Fp, Gll^Emf, Gs^Em, Gs^Fp, Hh^Fp, Hh^Fmw, Mm, Mm, Hh^Em, Mm, Mm, Md, Md, Md, Md, Md
Hh^Fdw, Hh^Fdw, Mm, Mm, Mm, Mm, Mm, Mm, Mm, Mm, Mm, Mm, Hh^Fdw, Hh^Fmw, Hh^Em, Hh^Fp, Hh^Fmw, Gll^Fmw, Hh^Fp, Hh^Fp, Gs^Fms, Gs^Fms, Gll^Fp, Hh^Fp, Mm, Mm, Hh^Fdw, Hh^Es, Hh^Fmw, Hh^Fmw, Hh^Em, Md, Md, Md
Hh^Es, Hh^Es, Hh^Es, Hh^Fdw, Mm, Mm, Wo, Wo, Wo, Wo, Hh, Hh^Es, Wwr, Hh^Es, Ww^Ewl, Gll^Fp, Gll^Fp, Gll^Fmw, Gs^Em, Gs^Em, Gs^Fp, Gs^Fms, Gll^Fmw, Hh^Fp, Hh^Fp, Mm, Mm, Hh, Hh^Es, Mm, Mm, Mm, Mm, Md
Ww, Hh^Fmw, Hh^Fmw, Mm, Mm, Wo, Wo, Wo, Wo, Wo, Wo, Wwr, Wwr, Ww^Ewl, Ww^Ewf, Ww^Ewl, Ww, Gg^Es, Gg^Efm, Gs, Gs, Hh^Fp, Mm, Gll^Emf, Hh^Fmw, Mm, Mm, Hh^Es, Hh^Es, Mm, Hh^Fdw, Mm, Mm, Mm
Hh, Ww^Ewl, Hh^Es, Mm, Ww^Ewl, Wo, Wo, Wo, Wo, Wo, Wwr, Wwr, Wwr, Wo, Wo, Ww, Ww, Gg^Efm, Gg, Gg^Es, Gs^Em, Hh^Fdw, Hh^Fmw, Mm, Hh^Fmw, Hh^Fdw, Mm, Hh, Hh^Fmw, Mm, Mm, Hh^Fdw, Hh^Es, Hh^Fmw
Hh, Ww^Ewl, Ww^Ewl, Hh^Es, Ww^Ewl, Ww^Ewl, Wo, Wo, Wo, Wo, Wo, Wo, Wo, Wo, Wwr, Wwr, Ww^Ewf, Ww^Ewl, Gg^Efm, Gs^Fmw, Gs, Gs^Fmw, Hh^Fmw, Mm, Hh^Fdw, Hh^Em, Mm, Mm, Mm, Mm, Mm, Hh, Hh^Es, Hh
Wwr, Wwr, Wwr, Ww, Wo, Wwr, Wwr, Wo, Wo, Wo, Wo, Wo, Wo, Wo, Wwr, Wwr, Ww, Ww^Ewl, Gs^Fp, Gs^Em, Gs, Gs^Em, Hh^Fdw, Hh^Em, Hh, Hh^Es, Mm, Mm, Hh^Fdw, Mm, Mm, Hh^Es, Hh^Fmw, Hh
Wwr, Wwr, Wo, Wwr, Wo, Wwr, Wwr, Ww, Ww, Ww, Wwr, Wwr, Wwr, Wwr, Wwr, Ww, Ww, Gs^Fp, Gs^Fmw, Gs^Fmw, Gs, Gs^Efm, Gg^Es, Hh^Em, Gs^Fmw, Gs^Fmw, Hh, Hh^Es, Hh^Es, Mm, Mm, Mm, Mm, Hh
Ww, Wo, Wo, Wo, Wo, Wo, Hh^Em, Ww, Ww, Ww, Ww^Ewf, Ww, Ww, Wwr, Ww, Ww, Mm, Hh, Mm, Gs^Efm, Gs, Gg^Efm, Gs^Fmw, Gs, Gs, Gs^Fmw, Gs, Hh^Fdw, Hh^Es, Hh^Fmw, Hh^Fmw, Mm, Mm, Mm
Mm, Mm, Mm, Mm, Mm, Mm, Hh^Fmw, Gs^Em, Gs^Fmw, Ww^Ewl, Ww^Ewl, Ww^Ewl, Ww, Ww, Hh^Em, Mm, Mm, Mm, Hh^Fmw, Hh, Gs^Fp, Gg^Es, Gs, Gg^Efm, Gg, Gs, Gg, Gg^Efm, Gs^Fmw, Hh, Gs^Em, Hh^Em, Hh^Fp, Hh^Fp
Mm, Mm, Mm, Mm, Mm, Mm, Mm, Hh^Em, Gs^Fp, Gs^Fmw, Hh^Em, Hh, Gll^Em, Ww^Ewf, Ww^Ewf, Hh^Fmw, Mm, Mm, Gs^Fms, Hh^Em, Gs^Em, Gs, Re^Vct, Gg^Efm, Gg^Es, Gg, Gg^Efm, Re^Vct, Gs^Fp, Gs^Fmw, Gs^Fp, Gs^Emf, Gs^Fms, Hh^Fp
Hh, Mm, Mm, Mm, Mm, Mm, Mm, Mm, Gs^Fp, Hh^Fp, Hh^Fmw, Hh^Fmw, Gll^Emf, Ww^Ewf, Ww^Ewf, Hh^Fmw, Gs^Fmw, Gs^Fp, Gs^Fp, Gs^Emf, Gs^Fp, Gs^Fmw, Gs, Gg, Ce, Ce, Ce, Gs^Fmw, Gs^Vct, Gs^Fmw, Gs^Fp, Gs^Fp, Gs^Fms, Gs^Fms
Mm, Hh^Fmw, Mm, Hh^Fmw, Mm, Mm, Mm, Mm, Hh^Fmw, Mm, Mm, Gs^Fmw, Hh, Ww, Ww, Gs^Fmw, Gs^Fp, Gs^Fms, Gs^Fms, Gs^Fmw, Gs^Efm, Gs^Fmw, Gs, Gg^Efm, Ce, 1 Ke, Ce, Gs^Em, Gs^Fmw, Gs^Fms, Gs^Fds, Gs^Fms, Gs^Fds, Gs^Fms
Mm, Mm, Mm, Hh^Fmw, Hh^Em, Mm, Mm, Mm, Mm, Mm, Wwr, Hh, Wwr, Wwr, Ww, Gs^Fmw, Gs^Fms, Gs^Fp, Gs^Fp, Gs^Fmw, Gs^Fp, Re^Vct, Gg^Es, Gg, Gg, Ce, Gs, Gs^Fp, Gs^Fp, Gs^Fms, Gs^Fp, Gs^Fms, Gg^Fet, Gs^Fds
Mm, Mm, Mm, Mm, Ww, Mm, Ww^Ewl, Ww, Ww, Ww, Mm, Wwr, Wwr, Wwr, Ww, Gs^Fmw, Gs^Fmw, Gs^Emf, Gs^Fmw, Gs^Fmw, Gs^Fp, Gs, Gs, Re^Vct, Gs, Gs^Efm, Gs^Em, Gs^Fp, Gs^Fp, Gs^Fp, Gs^Fp, Gs^Fms, Gs^Fds, Gs^Fds
Wo, Mm, Wo, Ww, Hh, Ww^Ewl, Mm, Mm, Mm, Mm, Hh^Fmw, Mm, Hh^Em, Ww^Ewl, Ww^Ewf, Ww, Gs^Em, Gs^Em, Gs^Efm, Gs, Gs, Gs^Efm, Gs^Fmw, Gs, Gs^Fmw, Gs^Efm, Gs^Fmw, Gs^Fp, Gs^Em, Gs^Fms, Gs^Fms, Gs^Fms, Gs^Fds, Gs^Fp
Wo, Wo, Mm, Hh, Mm, Mm, Mm, Mm, Mm, Mm, Hh^Fmw, Hh, Hh^Fmw, Ww^Ewl, Ww, Ww, Gs^Fmw, Gs^Fmw, Gs^Fmw, Gs^Efm, Gs, Gs^Fmw, Gs^Fmw, Gs^Em, Gs^Emf, Gs^Fmw, Gs^Fms, Gs^Fp, Gs^Fp, Gs^Emf, Gs^Fms, Gs^Fms, Gs^Fms, Gs^Fp
Ww^Ewl, Ww^Ewl, Mm, Mm, Mm, Mm, Hh^Fmw, Hh^Fmw, Hh, Mm, Hh^Fmw, Gs^Fp, Gs^Fp, Gs^Fmw, Ww, Ww, Ww, Gs^Fp, Gs^Fms, Gs^Fp, Gs^Em, Gs^Fp, Gs^Fms, Gs^Fms, Gs^Fms, Gs^Fds, Gs^Fms, Gs^Fms, Gs^Fms, Gs^Fds, Gs^Fms, Gs^Fds, Gs^Fms, Gs^Fp
Mm, Mm, Mm, Mm, Mm, Mm, Hh, Gs^Fp, Gs, Hh, Hh, Gs^Fmw, Gs, Gs^Fmw, Gs, Ww, Ww, Gs^Fp, Gs^Fp, Gs^Fp, Gg, Gs, Gs^Fp, Gs^Fds, Gs^Fds, Gs^Fds, Gs^Fp, Gs^Em, Gs, Gs^Fds, Gs^Fp, Gs^Fms, Gs^Fp, Gs^Fp
