Ha^Em, Ha^Fma, Ha^Fda, Ms, Ms, Ms, Ms, Ha, Ha^Fma, Ha^Fpa, Ha, Ha^Fma, Ha^Fda, Ha, Ha^Em, Ha, Ai, Ai, Ai, Ha, Ha^Fda, Ha, Ha^Fda, Ai, Ai, Ai, Aa^Fma, Ha, Ha^Fda, Ai, Ai, Ha, Ha, Ms, Ms, Ha, Ha^Fda, Ha, Ha^Fda, Ha, Ha^Fma, Ha, Ha^Fpa, Aa^Fpa, Ha^Fpa, Aa^Fpa, Ai, Ai
Ha^Fma, Ha^Fda, Ms, Ms, Ms, Ms, Ha^Fda, Ms, Ha^Fma, Ha^Fpa, Ha^Em, Ha^Fma, Ms, Ai^Es, Ai, Ha^Fda, Ha^Fda, Aa, Aa^Fma, Ha^Em, Ha^Fda, Ha^Fda, Aa^Fma, Aa^Fma, Ai, Ai^Es, Aa^Fma, Ha^Vea, Ha^Fda, Ai, Ai, Ai, Ha^Fda, Ms, Ms, Ha^Em, Ha, Ha^Em, Ha^Fda, Ha^Fda, Ha^Em, Ha^Fpa, Ms, Ha^Fda, Ha^Fpa, Aa^Fpa, Ha^Fda, Ai
Aa^Fma, Aa^Fma, Ha^Fda, Ms, Ms, Ms, Ms, Ha^Fpa, Ha^Fda, Ha^Fma, Aa^Fpa, Ms, Ha^Em, Ms, Ha^Em, Ha, Ha^Es, Aa^Em, Ha^Fda, Aa, Ha, Ha^Em, Aa^Fma, Aa^Fpa, Aa^Fma, Aa^Fma, Aa^Fma, Aa^Fma, Aa, Ai, Ai^Es, Ha, Ha, Ha^Fda, Ms, Ha, Ha^Fda, Ha, Ha^Fda, Ha, Ha^Vha, Ha^Fpa, Ms, Ms, Ha^Fpa, Ha^Fpa, Ha^Fda, Ha^Fpa
Ai, Ha^Em, Ha^Fda, Ms, Ms, Ms, Ha^Fda, Ha^Fpa, Ha, Ha^Em, Aa^Fma, Ha^Fpa, Ha^Fpa, Ha^Fpa, Ha^Fma, Ha^Fma, Ha^Vhha, Ha, Ha^Em, Aa^Em, Ms, Ha^Fda, Ms, Aa^Fma, Aa^Fpa, Aa^Fpa, Aa^Fma, Aa, Ha, Ai, Ai, Ai, Ai, Ai, Ha^Fda, Ms, Ha^Em, Ai, Ai, Ha, Ha^Fpa, Ms, Ms, Ms, Ms, Ms, Ms, Ha^Fpa
Ai, Ai, Ha, Ms, Ms, Ha^Em, Aa^Fpa, Ha^Es, Ha, Aa^Fma, Ha^Fpa, Ms, Ms, Ms, Ms, Ha^Fma, Ms, Ha^Fma, Ha^Fda, Ms, Ms, Ms, Ms, Ms, Ha^Em, Aa^Fma, Aa^Fma, Aa^Em, Ha^Em, Ai^Es, Ha^Fda, Ai, Ha, Ai^Es, Ha, Ha^Em, Ai, Ai^Es, Ai, Ha^Em, Ha^Fpa, Ha^Fpa, Ms, Ms, Ms, Ms, Ms, Ms
Ai, Ai^Es, Ai, Aa, Ms, Aa^Fda, Aa^Fma, Ha^Fda, Ha, Ha^Fda, Ha^Fda, Ms, Ms, Ms, Ms, Ms, Ms, Ms, Ms, Ha^Fda, Ms, Ms, Ms, Ms, Ha^Fda, Ms, Ha^Fda, Ha^Fda, Ms, Ms, Ha, Ha^Fda, Ha^Fda, Ha^Fda, Ha^Fpa, Ha^Fpa, Ha, Ha^Es, Aa, Aa^Fpa, Ha^Fpa, Ms, Ms, Ms, Ms, Ms, Ms, Ms
Ai, Ha^Em, Ha^Fda, Ha^Fda, Ha, Ai, Ai, Aa, Aa, Aa, Ha, Cha, Cha, Cha, Ms, Ha^Fda, Ms, Ms, Ms, Ms, Ms, Ms, Ms, Ha^Fda, Ms, Ms, Ms, Ms, Ms, Ms, Ms, Ms, Ha^Fda, Ha, Ha, Ha^Es, Aa^Fda, Aa^Fda, Aa^Fma, Aa^Fpa, Aa^Fma, Ha^Fda, Ms, Ms, Ur^Ii, Qxe^Ii, Ms, Ms
Ha^Fma, Ha^Fma, Ha^Fpa, Ha^Fma, Ha, Ha^Vhha, Ai, Ha, Ha^Fda, Ha^Em, Cha, Kha, Cha, Cha, Ha, Ha^Fda, Ha^Vhha, Ms, Ms, Ms, Ms, Ms, Ms, Ms, Ms, Ms, Ms, Ms, Ms, Ms, Ms^Xm, Ms^Xm, Ms, Ms, Ha^Fda, Ha^Em, Ha^Em, Aa^Fma, Aa^Fma, Aa^Fpa, Aa^Fma, Ha^Fda, Ha^Fda, Ur^Ii, Mm, Ms, Mm, Ms
Ha^Fpa, Ha^Fma, Ha^Fpa, Ha^Fpa, Ai, Ai^Es, Ai, Ha^Fda, Ai, Ms, Cha, Cha, Ha^Fda, Rr, Rr^Es, Ha^Em, Ha^Fda, Ms, Ms, Ms, Ms, Ms, Ms^Xm, Ms^Xm, Mm^Xm, Mm^Xm, Ms^Xm, Mm^Xm, Ms^Xm, Ms^Xm, Mm^Xm, Ms^Xm, Ms^Xm, Mm, Ha^Fma, Ha^Fma, Ha^Fda, Ha^Fma, Ha, Aa^Em, Aa^Fpa, Ha^Fpa, Ha^Fpa, Mm, Mm, Mm, Mm, Mm
Aa^Fma, Ha^Fma, Ha^Fpa, Ha^Fpa, Ha^Fpa, Aa, Aa^Fda, Ai, Ai^Es, Ms, Ms, Cha, Ha^Em, Ha, Ha^Es, Rr^Es, Ms, Ms, Ms, Ms, Ms, Ms, Mm, Ms^Xm, Mm^Xm, Mm^Xm, Cmy, Mm^Xm, Cmy, Ms^Xm, Mm^Xm, Ms^Xm, Mm, Mm, Mm, Ha^Fda, Hh^Fdw, Ha^Fpa, Ha^Fpa, Aa^Fpa, Hh^Fdw, Hh^Fdw, Hh^Fmw, Mm, Mm, Mm, Mm, Mm
Aa^Fma, Ha^Fma, Aa^Fma, Aa^Fma, Aa^Fma, Aa, Aa^Fda, Ai, Ai, Ms, Ms, Ha^Fda, Ha^Fda, Ha^Vea, Rr^Es, Rr, Ms, Ms, Ms, Ms, Ms, Ms^Xm, Ms^Xm, Mm^Xm, Brym, Cmy, Cmy, 2 Kmy, Cmy, Cmy, Brym, Mm^Xm, Mm^Xm, Mm^Xm, Mm, Hh, Hh, Ha, Ha^Fdw, Ha^Fpa, Hh^Fmw, Hh, Hh, Mm, Hh^Fmw, Mm, Ww^Ewl, Ww^Ewl
Ai, Ai, Ha^Fma, Ha, Ai^Es, Ai, Ai, Ai, Ai, Ms, Ms, Ms, Ms, Ms, Rr^Es, Ms, Mm, Mm, Mm, Mm, Mm^Xm, Ms^Xm, Mm^Xm, Brym, Brym^Vymb, Brym, Brym, Brym, Brym, Brym, Brym^Vymb, Brym, Mm^Xm, Mm^Xm, Mm, Mm, Hh, Hh^Fdw, Hh^Fdw, Hh^Fdw, Hh^Fmw, Hh^Fdw, Gll^Fmw, Hh^Fp, Hh^Fdw, Hh, Ww^Ewl, Ww^Ewf
Ms, Ha, Ha^Es, Ha, Ha^Fma, Ha, Ha^Es, Ha^Fma, Ha^Vha, Ai^Es, Ms, Ms, Ms, Ms, Rr, Ms, Mm, Mm, Mm, Mm, Mm^Xm, Mm^Xm, Mm^Xm, Brym, Brym, Brym^Vymb, Brym, Brym^Vymb, Brym, Brym^Vymb, Brym, Brym, Mm^Xm, Mm^Xm, Mm, Mm, Hh^Fmw, Hh, Hh^Fdw, Hh^Fp, Hh^Fdw, Hh^Fp, Ww^Ewl, Hh, Hh^Fdw, Ww^Ewl, Ww^Ewf, Ww
Ms, Ms, Ms, Ha^Fda, Ms, Ha^Fda, Ha, Ha^Es, Ha^Fda, Ha^Fda, Mm, Ms, Mm, Mm, Mm, Rr, Mm, Mm, Hh^Fdw, Mm, Mm, Mm^Xm, Mm^Xm, Mm^Xm, Brym^Vymb, Brym, Brym, Brym, Brym, Brym, Brym^Vymb, Mm^Xm, Mm^Xm, Mm^Xm, Mm, Mm, Hh^Fmw, Hh^Fmw, Gll^Fmw, Gll^Fmw, Ww, Ww, Hh^Fmw, Ww^Ewl, Ww^Ewl, Wwr, Wwr, Wwr
Mm, Mm, Hh^Em, Ms, Mm, Ms, Ha^Fda, Ha, Ha^Es, Mm, Hh^Fdw, Mm, Mm, Mm, Mm, Re^Es, Mm, Mm, Mm, Hh^Fdw, Mm, Mm, Mm^Xm, Mm^Xm, Mm^Xm, Brym^Vymb, Brym^Xo, Brym^Vymb, Brym^Xo, Brym^Vymb, Mm^Xm, Mm^Xm, Mm^Xm, Mm, Hh^Fdw, Mm, Hh^Fdw, Hh^Fp, Gll^Fp, Gll^Fp, Ww, Hh^Fdw, Hh, Ww^Ewl, Wwr, Wwr, Wwr, Wwr
Mm, Hh^Em, Mm, Mm, Mm, Mm, Mm, Hh^Em, Hh^Em, Hh^Em, Mm, Hh^Fdw, Mm, Mm, Mm, Re^Es, Mm, Hh^Fdw, Re^Es, Mm, Hh^Fdw, Mm, Mm, Mm^Xm, Mm^Xm, Mm^Xm, Cmy, Brym^Xo, Cmy, Mm^Xm, Mm, Mm, Hh^Es, Hh^Fdw, Mm, Mm, Hh^Fdw, Hh^Fp, Ww^Ewl, Ww, Gll^Em, Hh^Fdw, Gs^Fmw, Hh^Fdw, Hh, Ww, Ww^Ewl, Ww
Ww, Ai, Ai, Mm, Mm, Mm, Hh^Fdw, Hh^Fdw, Hh^Fmw, Hh^Fmw, Hh^Fdw, Mm, Mm, Mm, Mm, Re, Re, Hh^Es, Re^Es, Re^Vc, Hh^Em, Mm, Mm, Mm, Mm, Mm, Rrc, Cmy, Rrc, Mm, Mm, Hh^Fdw, Hh^Es, Gs^Fmw, Gs^Fdw, Hh^Em, Gll^Fp, Gll^Fp, Ww^Ewl, Gll^Fdw, Hh^Fp, Gll^Emf, Hh^Fp, Gs^Fmw, Hh^Fp, Ww^Ewl, Ww^Ewl, Ww^Ewl
Ww, Ww, Ww, Mm, Hh^Em, Mm, Mm, Hh^Fp, Hh^Fdw, Hh^Em, Mm, Mm, Mm, Mm, Hh^Fmw, Hh, Hh^Fdw, Re^Es, Re, Gs^Fmw, Gs^Em, Hh^Fdw, Mm, Mm, Mm, Mm, Rrc, Rrc, Mm, Mm, Wwr, Hh^Fdw, Gs^Fdw, Gs^Fmw, Hh^Fdw, Gs^Em, Ww, Wwr, Gll^Fmw, Gll^Fp, Gs^Fms, Gs^Fmw, Hh^Fp, Gs^Fmw, Hh^Fp, Hh^Fp, Hh^Fp, Gg^Fp
Ww, Ww, Ww, Ai, Ai^Ii, Mm, Mm, Hh^Fp, Hh^Em, Hh^Fmw, Hh^Fdw, Hh^Fdw, Hh^Em, Hh^Fdw, Hh^Fdw, Hh, Gs^Vh, Re^Es, Gs^Efm, Re, Re, Re, Rr, Hh^Fdw, Rr, Mm, Ch, Rrc, Mm, Hh^Fdw, Wwr, Ww^Ewl, Ww^Ewl, Hh, Ww^Ewl, Hh, Wwr, Wwr, Gs^Fmw, Gs^Fp, Hh^Fp, Hh^Em, Gs^Fms, Gs^Fms, Gs^Fds, Hh^Fp, Hh^Fms, Hh^Fp
Ww, Ww, Ai^Ii, Ww^Ii, Ai^Ii, Mm, Mm, Hh^Fmw, Hh^Em, Hh^Fdw, Hh^Em, Gs^Em, Gs^Fdw, Gs^Em, Hh, Hh, Gs^Fmw, Gs^Fmw, Gs^Em, Gs, Gs^Fdw, Gg^Efm, Gs, Rr, Gg^Efm, Rr, Hh, Mm, Hh^Fdw, Ww, Wwr, Wwr, Ww^Ewf, Ww^Ewl, Ww, Ww, Wwr, Wwr, Gg^Efm, Gs^Fp, Hh^Fms, Gg^Fp, Gs^Fds, Hh^Fp, Hh^Fp, Hh^Fp, Hh^Fms, Hh^Fms
Mm, Mm, Mm, Ww^Ii, Gd^Ii, Mm, Hh^Fdw, Hh^Fdw, Gll^Fmw, Gll^Emf, Gs^Em, Gs, Gll^Fmw, Gs^Fdw, Gll^Fmw, Hh^Fmw, Gll^Em, Gll^Fp, Hh, Gs^Fmw, Hh^Fdw, Gs^Em, Gs^Fmw, Gs, Re^Gvs, Rr, Gg, Hh^Em, Ww^Ewl, Wwr, Ww, Ww^Ewf, Wwr, Wwr, Wwr, Ww, Re^Es, Gg, Gs^Fmw, Gs^Fmw, Gg^Fp, Gg^Efm, Gs^Fms, Gs^Fds, Gs^Em, Gg^Efm, Hh^Fp, Hh^Fds
Hh^Em, Mm, Mm, Hh^Em, Mm, Gd, Gll^Es, Gll^Fmw, Hh, Gll^Em, Hh, Gll^Fmw, Hh^Fp, Hh^Fp, Hh^Fp, Gll^Fp, Hh, Gs^Fp, Hh^Fmw, Gs^Em, Gs^Fdw, Hh^Fdw, Gs^Es, Re^Gvs, Re^Gvs, Rr, Gg, Gg^Efm, Ww^Ewl, Ww^Ewl, Wwr, Ww, Ww, Ww^Ewf, Ww^Ewl, Ww, Re, Gg^Efm, Gs^Em, Gs^Fms, Gs^Fms, Hh^Fp, Hh^Em, Gs^Fms, Gs^Fds, Gg^Ve, Gs^Fms, Gg^Fp
Mm, Mm, Hh^Fmw, Hh^Fdw, Mm, Hh^Em, Gll^Fmw, Gll, Hh, Hh^Es, Gs^Fp, Gll^Fp, Gg^Fms, Hh^Fp, Gd^Ii, Gll^Fp, Hh^Fp, Gll^Emf, Gs^Fmw, Gs^Em, Gs, Hh^Es, Gs^Es, Re^Gvs, Rr^Es, Rr, Re, Gg^Efm, Gg, Gs^Fmw, Ww^Ewl, Ww, Ww, Ww^Ewl, Re, Re^Es, Gs^Efm, Gs^Fmw, Gs^Fp, Gs^Em, Hh^Fp, Gs^Fms, Gs^Fms, Gs^Fms, Gs^Fp, Gs^Fms, Hh^Fp, Gs^Fms
Hh^Es, Hh^Em, Hh^Fmw, Mm, Hh^Em, Hh^Es, Gs^Em, Gll^Em, Gll^Emf, Gs^Ve, Hh^Fp, Hh^Fds, Gs^Fms, Gd^Ii, Gd^Fetd, Gd^Ii, Gs^Fms, Hh^Fp, Hh^Fp, Hh^Em, Gs^Fmw, Gs^Fmw, Gs, Re^Vwm, Gs, Gg, Gg^Efm, Re, Re^Es, Re^Es, Re, Re^Es, Ww^Bsb\, Ww^Ewl, Re, Gs, Gs^Em, Gs^Fp, Gs^Fmw, Gs^Fp, Gs^Fp, Gs^Fms, Gs^Fms, Hh^Fp, Hh^Fp, Gs^Fms, Gs^Em, Hh^Fp
Hh^Fdw, Hh^Es, Hh^Em, Hh, Hh^Em, Gll^Fmw, Hh^Es, Gll^Em, Hh, Hh^Fp, Hh^Fp, Hh, Gs^Fms, Gd^Ii, Gd^Ii, Gd^Ii, Gs^Fms, Gs^Fds, Hh^Fms, Gs^Em, Gs, Gs, Gs^Em, Gs^Fp, Gs^Em, Gs^Fdw, Gg, Gg^Efm, Re^Es, Gg, Gs^Fmw, Ww^Ewl, Ww^Ewl, Re^Es, Gs, Gs^Es, Gs^Fp, Gs^Em, Gs, Gs, Gs^Fmw, Gs^Fmw, Hh^Fp, Gg^Efm, Gs^Fms, Gs^Fp, Gg^Ve, Gs
Hh^Em, Hh^Fdw, Hh^Es, Hh, Gs^Es, Hh^Es, Gs, Gs^Es, Gs^Fmw, Gs^Fp, Gs^Fmw, Gs^Fms, Gs^Fms, Gs^Fp, Gs^Fms, Hh^Fp, Hh^Fp, Gs^Fp, Gs^Fp, Gs, Hh^Es, Hh^Fmw, Gs^Fmw, Gs^Fmw, Gs^Fmw, Gg^Efm, Gs, Gg, Gs^Vc, Gs, Gs^Fmw, Ww, Ww^Ewl, Re^Es, Re, Gs, Gs^Efm, Gs^Fmw, Gs^Fp, Gg^Efm, Gg^Em, Gg^Fp, Hh^Fp, Gs^Em, Gs^Fp, Gs^Fp, Gs^Fms, Gs^Fms
Hh^Fdw, Hh^Fdw, Hh^Em, Gs^Vc, Gs^Efm, Hh^Fmw, Hh^Fmw, Gg, Gs, Hh, Hh^Fp, Gs^Fp, Hh^Fmw, Gs^Em, Hh^Fms, Hh^Fp, Gs^Fms, Gs^Fms, Gs^Vl, Gs^Em, Hh^Es, Hh^Fmw, Gs^Fmw, Gs^Vh, Gs^Em, Gg, Hh^Es, Gs, Gs, Gs^Es, Gs, Ww, Ww, Gs, Gs^Fmw, Re^Es, Gs^Em, Gs^Fmw, Gg^Efm, Gg, Gg, Gs^Fmw, Gs^Fmw, Gs^Fp, Gg^Fp, Gs^Fp, Gs^Fms, Gs^Fds
Mm, Mm, Mm, Hh^Es, Gs, Gg^Efm, Gg, Gg^Efm, Hh^Es, Gs^Fmw, Gs^Em, Gs^Fmw, Hh, Hh^Fp, Mm, Hh^Fp, Hh^Fds, Hh^Fms, Hh^Fp, Hh^Fp, Hh^Fms, Hh^Fp, Hh^Fp, Gs^Em, Gs^Fmw, Gs^Fmw, Hh, Gs, Gs, Gg, Gg^Efm, Ww^Ewl, Ww, Ww, Gs^Fp, Re^Es, Gs, Gs, Gg^Em, Gs^Fp, Gg, Gg, Gg^Efm, Gg^Em, Gg^Fp, Gg^Em, Gg^Fp, Gg^Fp
Mm, Mm, Mm, Mm, Mm, Hh^Es, Gs, Hh^Fdw, Mm, Gs^Fmw, Gs, Gg^Efm, Gs^Em, Hh^Em, Mm, Mm, Hh^Fms, Gs^Fms, Gs^Fds, Gs^Fp, Hh^Fp, Mm, Mm, Hh^Es, Hh, Hh, Re^Vwm, Re^Gvs, Gs^Es, Gs, Gg^Efm, Gs^Fmw, Ww^Ewl, Ww^Ewl, Re, Re, Re, Rp, Rp, Gs, Gg^Efm, Gg^Fp, Gg^Es, Gg^Fms, Gg^Fms, Gg^Fp, Gg^Emf, Gg^Fp
Mm, Mm, Mm, Mm, Hh^Fdw, Hh^Em, 1 Gs, Hh^Fdw, Gg, Hh^Es, Gg^Es, Gg, Gs^Fmw, Hh^Fp, Gs^Fms, Hh^Em, Gs^Fds, Gs^Fms, Gs^Fms, Gs^Fp, Gs^Fp, Hh^Fp, Hh^Fp, Hh, Gs^Es, Hh, Re^Gvs, Re^Gvs, Gs^Es, Gs, Gs, Gs^Em, Re, Ww^Bw/, Gs^Fdw, Gs^Efm, Gs^Es, Gs^Fdw, Rp, Gg^Em, Gs^Es, Gg^Vh, Gg, Gg^Fp, Gg^Fp, Gg^Fp, Gg^Em, Gg^Em
Mm, Mm, Mm, Mm, Hh^Fdw, Gs^Em, Gs, Gs^Es, Hh, Gg^Efm, Hh, Gs^Es, Hh^Em, Gs^Fp, Gs^Fms, Gs^Fms, Hh^Fp, Hh^Fms, Gs^Fp, Gs^Em, Hh, Hh^Fp, Hh^Fp, Gs^Em, Gs^Fmw, Gs^Es, Gs, Gs, Gg^Efm, Gg, Re^Es, Re, Gg^Es, Ww^Ewl, Gs^Fmw, Re^Es, Re^Gvs, Re^Gvs, Rp, Gs, Rp^Es, Gs, Gg^Efm, Gg^Em, Gg^Vl, Gg^Fp, Gg, Gg^Fp
Mm, Mm, Mm, Mm, Gd, Gs, Hh^Fdw, Hh^Es, Mm, Hh^Fdw, Mm, Hh^Es, Hh^Es, Gs^Fp, Hh^Fmw, Gs^Fms, Hh^Fds, Gs^Fms, Rp, Rp, Rp, Gs^Em, Gs^Fmw, Gs, Rp, Re, Re^Es, Re, Re^Es, Re, Re^Es, Gs^Fdw, Gs^Fp, Ww, Ww, Re^Es, Re^Gvs, Re^Vwm, Re^Gvs, Rp, Gg, Ce, Gg, Gg, Gg, Gg^Em, Gg^Fp, Gg^Fms
Mm, Mm, Mm, Hh^Es, Gd^Es, Gd^Fmw, Hh^Fdw, Mm, Mm, Mm, Mm, Mm, Hh^Fdw, Hh^Fmw, Hh^Fp, Gs^Fms, Gs^Fms, Gs^Fp, Gs^Fmw, Gs^Es, Gs, Rp^Es, Rp, Rp, Gg^Efm, Gg, Gs^Fmw, Gs^Fp, Gs^Fmw, Gs^Fp, Gg^Ve, Gll^Fmw, Gs^Fp, Gg^Em, Gs^Fdw, Ww, Re^Es, Re^Gvs, Gs, Gs, Gs, Gg^Efm, Gg^Fp, Gg^Es, Gg^Fp, Gg^Efm, Gg^Fp, Gg^Fms
Mm, Mm, Hh^Fdw, Gd^Fdw, Gd^Es, Hh^Es, Mm, Mm, Mm, Mm, Mm, Hh^Fdw, Mm, Hh^Es, Hh^Fp, Hh^Fp, Gs^Fms, Hh^Fp, Hh^Fp, Gs^Fmw, Gs^Em, Gs^Fp, Hh^Fmw, Hh^Fmw, Gs^Fmw, Gg^Em, Gs^Fmw, Gll^Fp, Gll^Fdw, Gs^Fp, Gs^Fp, Gg^Efm, Gs^Fmw, Gs^Fmw, Gs^Fdw, Ww^Ewl, Gs^Es, Gs^Vh, Gs^Fp, Gg^Efm, Gs^Fmw, Gg^Ve, Gg^Em, Gg^Em, Gg^Fms, Gg^Efm, Gg^Es, Gg^Fp
Mm, Mm, Hh, Gd^Fmw, Gll^Fmw, Hh^Fdw, Mm, Mm, Mm, Mm, Rr, Mm, Gs^Fp, Mm, Hh, Hh^Fmw, Gg, Hh^Fp, Gs^Fp, Hh^Fp, Gg, Gs^Fp, Hh, Hh, Gg, Gg, Gg, Gg^Em, Gg, Gll^Fmw, Gg^Em, Gs^Fp, Gg, Gs^Fmw, Gg, Ww^Ewl, Ww, Gs^Fmw, Gs^Fp, Gg^Em, Gg, Hh, Hh, Gg^Fp, Gg^Fp, Gg^Fp, Gg, Gg
