border_size=1
usage=map

Ha, Ha, Ha, Ms, Ms, Ms, Ms, Ha, Ha^Fpa, Ha^Fpa, Ha^Fpa, Ha^Fpa, Ha^Fpa, Ha, Ha, Ha, Ai, Ai, Ai, Ha, Ha, Ha, Ha, Ai, Ai, Ai, Aa^Fpa, Ha, Ha, Ai, Ai, Ha, Ha, Ms, Ms, Ha, Ha, Ha, Ha, Ha, Ha^Fpa, Ha, Ha^Fpa, Aa^Fpa, Ha^Fpa, Aa^Fpa, Ai, Ai
Ha, Ha, Ms, Ms, Ms, Ms, Ha, Ms, Ha^Fpa, Ha^Fpa, Ha^Fpa, Ha^Fpa, Ms, Ai, Ai, Ha, Ha, Aa, Aa^Vha, Ha, Ha, Ha, Aa^Fpa, Aa^Fpa, Ai, Ai, Aa^Fpa, Ha^Vhha, Ha, Ai, Ai, Ai, Ha, Ms, Ms, Ha, Ha, Ha, Ha^Fpa, Ha^Fpa, Ha, Ha^Fpa, Ms, Ha^Fpa, Ha^Fpa, Aa^Fpa, Ha^Fpa, Ai
Aa, Aa, Ha, Ms, Ms, Ms, Ms, Ha, Ha, Ha^Fpa, Aa, Ms, Ha, Ms, Ha, Ha, Ha, Aa, Ha, Aa, Ha, Ha, Aa^Fpa, Aa^Fpa, Ai, Aa^Fpa, Aa^Fpa, Aa^Fpa, Aa, Ai, Ai, Ha, Ha, Ha, Ms, Ha^Vhha, Ha, Ha, Ha^Fpa, Ha, Ha^Vhha, Ha, Ms, Ms, Ha^Fpa, Ha^Fpa, Ha^Fpa, Ha^Fpa
Ai, Ha, Ha, Ms, Ms, Ms, Ha, Ha, Ha, Ha, Aa, Ms, Ha, Ha, Ha, Ha, Ha^Vhha, Ha, Ha, Aa, Ms, Ha, Ms, Aa^Fpa, Aa^Fpa, Aa^Fpa, Aa^Fpa, Aa, Ha, Ai, Ai, Ai, Ai, Ai, Ha, Ms, Ha, Ai, Ai, Ha, Ha, Ms, Ms, Ms, Ms, Ms, Ms, Ha^Fpa
Ai, Ai, Ha, Ms, Ms, Ha, Aa, Ha, Ha, Aa, Ha, Ms, Ms, Ms, Ms, Ha, Ms, Ha, Ha, Ms, Ms, Ms, Ms, Ms, Ha, Aa^Fma, Aa^Fma, Aa, Ha, Ai, Ha, Ai, Ha, Ai, Ha, Ha, Ai, Ai, Ai, Ha, Ha^Fpa, Ha, Ms, Ms, Ms, Ms, Ms, Ms
Ai, Ai, Ai, Aa^Vha, Ms, Ai, Aa, Ha, Ha, Ha, Ha, Ms, Ms, Ms, Ms, Ms, Ms, Ms, Ms, Ha, Ms, Ms, Ms, Ms, Ha, Ms, Ha, Ha, Ms, Ms, Ha^Vhha, Ha, Ha, Ha, Ha, Ha, Ha, Ha, Aa, Ai^Fpa, Ha^Fpa, Ms, Ms, Ms, Ms, Ms, Ms, Ms
Ai, Ha, Ha, Ha, Ha, Ai, Ai, Aa, Aa, Aa, Ha, Cha, Cha, Cha, Ms, Ms, Ms, Ms, Ms, Ms, Ms, Ms, Ms, Ha, Ms, Ms, Ms, Ms, Ms, Ms, Ms, Ms, Ha, Ha, Ha, Ha, Aa^Fpa, Aa^Fpa, Aa^Fpa, Aa^Fpa, Aa^Fpa, Ha^Fpa, Ms, Ms, Ur^Ii, Qxe^Ii, Ms, Ms
Ha^Fpa, Ha^Fpa, Ha^Fpa, Ha, Ha, Ha^Vhha, Ai, Ha, Ha, Ha, Cha, Kha, Cha, Cha, Ha, Ha, Ha^Vhha, Ms, Ms, Ms, Ms, Ms, Ms, Ms, Ms, Ms, Ms, Ms, Ms, Ms, Ms^Xm, Ms^Xm, Ms, Ms, Ha, Ha, Ha, Aa^Fpa, Aa^Fpa, Aa^Fpa, Aa^Fpa, Ha^Fpa, Ha^Fpa, Ur^Ii, Mm, Ms, Mm, Ms
Ha^Fpa, Ha^Fpa, Ha^Fpa, Ha, Aa, Aa, Ai, Ha, Ai, Ms, Cha, Cha, Ha, Rr, Rr, Ha, Ha, Ms, Ms, Ms, Ms, Ms, Ms^Xm, Ms^Xm, Mm^Xm, Mm^Xm, Ms^Xm, Mm^Xm, Ms^Xm, Ms^Xm, Mm^Xm, Ms^Xm, Ms^Xm, Mm, Ha, Ha, Ha^Fpa, Ha^Fpa, Ha^Fpa, Aa^Fpa, Aa^Fpa, Ha^Fpa, Ha^Fpa, Mm, Mm, Mm, Mm, Mm
Aa^Fpa, Ha^Fpa, Ha^Fpa, Ha^Fpa, Ha^Fpa, Aa, Ai, Ai, Ai, Ms, Ms, Cha, Ha, Ha, Ha, Rr, Ms, Ha, Ms, Ms, Ms, Ms, Mm, Ms^Xm, Mm^Xm, Mm^Xm, Cmy, Mm^Xm, Cmy, Ms^Xm, Mm^Xm, Ms^Xm, Mm, Mm, Mm, Ha, Hh, Ha^Fpa, Ha^Fpa, Aa^Fpa, Hh^Fpa, Hh^Fpa, Hh^Fp, Mm, Mm, Mm, Mm, Mm
Ai, Ha^Fma, Aa^Fma, Aa^Fma, Aa^Fma, Aa, Ai, Ai, Ai, Ms, Ms, Ha, Ha, Ha^Vhha, Rr, Rr, Ms, Ms, Ms, Ms, Ms, Ms^Xm, Ms^Xm, Mm^Xm, Brym, Cmy, Cmy, 2 Kmy, Cmy, Cmy, Brym, Mm^Xm, Mm^Xm, Mm^Xm, Mm, Hh, Hh, Ha^Fpa, Ha^Fpa, Ha^Fpa, Hh^Fpa, Hh^Fp, Hh^Fp, Mm, Hh^Fp, Mm, Ww, Ww
Ai, Ai, Ha^Fma, Ha^Vhha, Ai, Ai, Ai, Ai, Ai, Ms, Ms, Ms, Ms, Ms, Rr, Ms, Ms, Ms, Mm, Mm, Mm, Ms^Xm, Mm^Xm, Brym, Brym^Vymb, Brym, Brym, Brym, Brym, Brym, Brym^Vymb, Brym, Mm^Xm, Mm^Xm, Mm, Mm, Hh, Hh^Fpa, Hh^Fp, Hh^Fpa, Hh^Fp, Hh^Fp, Gs^Fp, Hh^Fp, Hh^Fp, Hh, Ww, Ww
Ms, Ha, Ha, Ha, Ha, Ha, Ha, Ha, Ha^Vhha, Ai, Ms, Ms, Ms, Ms, Rr, Ms, Ms, Ms, Mm, Mm, Mm, Mm^Xm, Mm^Xm, Brym, Brym, Brym^Vymb, Brym, Brym^Vymb, Brym, Brym^Vymb, Brym, Brym, Mm^Xm, Mm, Mm, Mm, Hh, Hh, Hh^Fp, Hh^Fp, Hh^Fp, Hh^Fp, Ww, Hh, Hh, Ww, Ww, Ww
Ms, Ms, Ms, Ha, Ms, Ha, Ha, Ha, Ha, Ha, Mm, Ms, Mm, Mm, Mm, Rr, Mm, Mm, Hh, Mm, Mm, Mm, Mm^Xm, Mm^Xm, Brym^Vymb, Brym, Brym, Brym, Brym, Brym, Brym^Vymb, Mm^Xm, Mm^Xm, Mm, Mm, Mm, Hh, Hh, Gg^Fp, Gg^Fp, Ww, Ww, Hh^Fp, Ww, Ww, Ww, Ww, Ww
Mm, Mm, Mm, Ms, Mm, Ms, Ha, Ha, Ha, Mm, Hh, Mm, Mm, Mm, Mm, Rr, Mm, Mm, Mm, Hh, Hh, Hh, Hh, Mm^Xm, Mm^Xm, Brym^Vymb, Brym^Xo, Brym^Vymb, Brym^Xo, Brym^Vymb, Mm^Xm, Mm^Xm, Mm^Xm, Mm, Hh, Mm, Hh, Hh^Fp, Gs^Fp, Gg^Fp, Ww, Hh^Fp, Hh^Fp, Ww, Ww, Ww, Ww, Ww
Mm, Mm, Mm, Mm, Mm, Mm, Mm, Hh, Hh, Hh, Mm, Hh, Mm, Mm, Mm, Rr, Mm, Hh, Gg, Mm, Hh, Mm, Hh, Hh, Mm, Mm^Xm, Cmy, Brym^Xo, Cmy, Mm^Xm, Hh, Mm, Hh, Hh, Mm, Mm, Hh^Fp, Hh^Fp, Ww, Ww, Gg^Fp, Hh^Fp, Gg^Fp, Hh^Fp, Hh, Ww, Ww, Ww
Ww, Ai, Ai, Mm, Mm, Mm, Hh, Hh, Hh, Hh, Hh, Mm, Mm, Mm, Mm, Rr, Rr, Hh, Gg, Gs^Vh, Hh, Mm, Mm, Hh, Mm, Mm, Rrc, Cmy, Rrc, Mm, Mm, Hh, Hh, Hh, Gg, Hh, Gg^Fp, Gg^Fp, Ww, Gs^Fp, Hh^Fp, Gg^Fp, Hh^Fp, Gg^Fp, Hh^Fp, Ww, Ww, Ww
Ww, Ww, Ww, Mm, Hh, Mm, Mm, Hh, Hh, Hh, Mm, Mm, Mm, Mm, Hh, Hh, Hh, Rr, Rr, Gg, Gg, Hh, Mm, Mm, Mm, Mm, Rrc, Rrc, Mm, Mm, Ww, Hh, Gg, Gg, Gg, Gg, Gg, Ww, Gs^Fp, Gs^Fp, Gg^Fp, Gg^Fp, Hh^Fp, Gg^Fp, Hh^Fp, Hh^Fp, Hh^Fp, Gg^Fp
Ww, Ww, Ww, Ai, Ai^Ii, Mm, Mm, Hh, Hh, Hh, Hh, Hh, Hh, Hh, Hh, Hh, Gs^Vh, Gg, Gg, Rr, Rr, Rr, Rr, Hh, Hh, Mm, Ch, Rrc, Mm, Hh, Ww, Ww, Ww, Gg, Ww, Gg, Ww, Ww, Gg^Fp, Gs^Fp, Hh^Fp, Hh^Fp, Gs^Fp, Gg^Fp, Gg^Fp, Hh^Fp, Hh^Fp, Hh^Fp
Ww, Ww, Ai^Ii, Ww^Ii, Ai^Ii, Mm, Mm, Hh, Hh, Hh, Hh, Gg, Gg, Gg, Hh, Hh, Gg, Gg, Gg, Gg, Gg, Gg, Gg, Rr, Rr, Rr, Hh, Mm, Hh, Ww, Ww, Ww, Ww, Ww, Ww, Ww, Ww, Gg, Gg, Gs^Fp, Hh^Fp, Gg^Fp, Gg^Fp, Hh^Fp, Hh^Fp, Hh^Fp, Hh^Fp, Hh^Fp
Mm, Mm, Mm, Ww^Ii, Gg^Ii, Mm, Hh, Hh, Gg, Gg, Gg, Gg, Gg^Fp, Gg^Fp, Gg^Fp, Hh^Fp, Hh, Gg, Hh, Gg, Hh, Gg, Gg, Rr, Rr, Rr, Gg, Hh, Ww, Ww, Ww, Ww, Ww, Ww, Ww, Ww, Gg, Gg, Gg^Fp, Gg^Fp, Gg^Fp, Gg^Fp, Gg^Fp, Gs^Fp, Gg^Fp, Gg^Fp, Hh^Fp, Hh^Fp
Mm, Mm, Mm, Hh, Mm, Gg, Gg, Gg, Gg, Gg, Gg, Gg^Fp, Gg^Fp, Gg^Fp, Gg^Fp, Gg^Fp, Gg, Hh, Gg, Hh, Gg, Hh, Gg, Gg, Gg, Rr, Gg, Gg, Ww, Ww, Ww, Ww, Ww, Ww, Ww, Ww, Gg, Gg, Gg^Fp, Gg^Fp, Gg^Fp, Hh^Fp, Hh^Fp, Gg^Fp, Gg^Fp, Gg^Fp, Gg^Fp, Gg^Fp
Mm, Mm, Hh, Hh, Mm, Hh, Gg, Gg, Gg, Gg, Gs^Fp, Gg^Fp, Gg^Fp, Gg^Fp, Gd^Ii, Gg^Fp, Gg^Fp, Gg, Gg, Gg, Gg, Hh, Hh, Gg, Gg, Rr, Rr, Gg, Gg, Gs^Fp, Ww, Ww, Ww, Ww, Rr, Gg, Gg, Gg, Gg^Fp, Gg^Fp, Hh^Fp, Gg^Fp, Gg^Fp, Gg^Fp, Hh^Fp, Gg^Fp, Hh^Fp, Gg^Fp
Hh, Hh, Hh, Mm, Hh, Hh, Gg, Gg, Gg, Gs^Vh, Gs^Fp, Gs^Fp, Gg^Fp, Gd^Ii, Gd^Fetd, Gd^Ii, Gg^Fp, Gs^Fp, Gg, Gg, Gg, Gg, Hh, Gs^Vh, Gg, Gg, Gg, Rr, Rr, Rr, Rr, Rr, Ww^Bsb\, Ww, Rr, Gg, Gg^Fp, Gg, Gg, Gg^Fp, Gg^Fp, Gll^Fp, Gll^Fp, Hh^Fp, Hh^Fp, Gg^Fp, Gg^Fp, Hh^Fp
Hh, Hh, Hh, Hh, Hh, Gg, Gg, Gg, Gg, Gg^Fp, Gg^Fp, Gs^Fp, Gs^Fp, Gd^Ii, Gd^Ii, Gd^Ii, Gs^Fp, Gs^Fp, Gg, Gg, Gg, Gg, Hh, Gg, Gg, Gg, Gg, Gg, Gg, Gg, Gg, Ww, Ww, Rr, Gg, Gg, Gg^Fp, Gg^Fp, Gg, Gg^Fp, Gg^Fp, Gg^Fp, Hh^Fp, Gs^Fp, Gg^Fp, Gs^Fp, Gg^Fp, Gg^Fp
Hh, Hh, Hh, Hh, Gg, Gg, Gs^Vh, Gg, Gg, Gg^Fp, Gs^Fp, Gg^Fp, Gg^Fp, Gs^Fp, Gs^Fp, Gs^Fp, Gs^Fp, Gg^Fp, Gg^Fp, Gg, Hh, Hh, Gg, Gg, Gg, Gg, Gg, Gg, Gg^Vh, Gg, Gg, Ww, Ww, Rr, Rr, Gg, Gg, Gg^Fp, Gg^Fp, Gg, Gg, Gg^Fp, Hh^Fp, Gs^Fp, Gs^Fp, Gs^Fp, Gg^Fp, Gll^Fp
Hh, Hh, Hh, Gg^Vh, Gg, Gg, Gg, Gg, Gg, Hh, Hh^Fp, Hh^Fp, Hh, Gg, Gs^Fp, Gs^Fp, Gs^Fp, Gs^Fp, Gg^Vh, Gg, Hh, Hh, Gg, Gs^Vh, Gg, Gg, Hh, Gg, Gg, Gg, Gg, Ww, Ww, Gg, Gg, Rr, Gg, Gg^Fp, Gg, Gg, Gg, Gg^Fp, Gg^Fp, Gg^Fp, Gg^Fp, Gg^Fp, Gll^Fp, Gg^Fp
Mm, Mm, Mm, Hh, Gg, Gg, Gg, Gg, Gg, Gg, Gg, Gg, Gg, Hh^Fp, Hh^Fp, Hh^Fp, Hh^Fp, Hh^Fp, Hh^Fp, Hh^Fp, Gg^Fp, Hh, Hh, Gg, Gg, Gg, Hh, Gg, Gg, Gg, Gg, Ww, Ww, Ww, Gs^Fp, Rr, Gg, Gg, Gg, Gg, Gg, Gg, Gg, Gg, Gg, Gg, Gg^Fp, Gg^Fp
Mm, Mm, Mm, Mm, Mm, Hh, Gg, Gg, Gg, Gg, Gs^Vh, Gg, Gg, Gg, Gs^Fp, Gs^Fp, Gs^Fp, Gg^Fp, Gg^Fp, Gg^Fp, Gg^Fp, Hh^Fp, Hh, Hh, Hh, Hh, Gs^Vh, Gg, Gg, Gg, Gg, Gg, Ww, Ww, Rr, Rr, Rr, Rp, Rp, Gg, Gg, Gg, Gg, Gg^Fp, Gg^Fp, Gg, Gg, Gg^Fp
Mm, Mm, Mm, Mm, Hh, Hh, 1 Gg, Gg, Gg, Gg, Gg, Gg, Gg^Fp, Gg, Gg^Fp, Gs^Fp, Gg^Fp, Gg^Fp, Gg^Fp, Gg^Fp, Gs^Fp, Gs^Fp, Gs^Fp, Hh, Gg, Hh, Gg, Gg, Gg, Gg, Gg, Gg, Rr, Ww^Bw/, Gg, Gg, Gg, Gg, Rp, Gg, Gg, Gg^Vh, Gg, Gg^Fp, Gg^Fp, Gg, Gg, Gg
Mm, Mm, Mm, Mm, Hh, Gg, Gg, Gg, Hh, Gg, Hh, Gg, Hh, Gg^Fp, Gs^Fp, Gg^Fp, Gg^Fp, Gg^Fp, Gg, Gg, Gg, Gs^Fp, Gg^Fp, Gg, Gg, Gg, Gg, Gg, Rr, Rr, Rr, Rr, Gg, Ww, Gg, Gg, Gg, Gg, Rp, Gg, Rp, Gg, Gg, Gg, Gg^Vh, Gg^Fp, Gg, Gg
Mm, Mm, Mm, Mm, Gg, Gg, Hh, Hh, Mm, Hh, Mm, Hh, Hh, Gs^Fp, Hh^Fp, Gs^Fp, Gg^Fp, Gg^Fp, Rp, Rp, Rp, Gg, Gg, Gg, Rp, Rr, Rr, Rr, Gg, Gg, Gg^Ve, Gs^Fp, Gs^Fp, Ww, Ww, Gg, Gg, Gg^Vh, Gg, Rp, Gg, Kh, Gg, Gg, Gg, Gg, Gg, Gg^Fp
Mm, Mm, Mm, Hh, Gg, Gll^Fp, Hh, Mm, Mm, Mm, Mm, Mm, Hh, Hh, Hh, Gg^Fp, Gg^Fp, Gg, Gg, Gg, Gg, Rp, Rp, Rr, Gg, Gg, Gg, Gs^Fp, Gs^Fp, Gs^Fp, Gs^Fp, Gs^Fp, Gs^Fp, Gg, Gg, Ww, Gg, Gg, Gg, Gg, Gg, Gg, Gg, Gg, Gg^Fp, Gg, Gg^Fp, Gg^Fp
Mm, Mm, Hh, Gg, Gg, Hh, Mm, Mm, Mm, Mm, Mm, Hh, Mm, Hh, Hh^Fp, Hh^Fp, Gg^Fp, Gg^Fp, Gs^Fp, Gs^Fp, Gg, Gg, Gg, Gg, Gg, Gg, Gg, Gg, Gg, Gg, Gg, Gg, Gg, Gg, Gg, Ww, Gg, Gs^Vh, Gs^Fp, Gg, Gs^Fp, Gg^Vh, Gg, Gg, Gg^Fp, Gg, Gg, Gg
Mm, Mm, Hh, Gll^Fp, Gll^Fp, Hh, Mm, Mm, Mm, Mm, Rr, Mm, Gs^Fp, Mm, Hh, Hh^Fp, Gg, Gs^Fp, Gs^Fp, Gs^Fp, Gg, Gg, Gg, Gg, Gg, Gg, Gg, Gg, Gg, Gg, Gg, Gg, Gg, Gg, Gg, Ww, Ww, Gs^Fp, Gs^Fp, Gg, Gg, Hh, Hh, Gg, Gg, Gg, Gg, Gg
