Wwg, Wwg, Wog, Xu, Xu, Xu, Xu, Xu, Xu, Uu, Xu, Xu, Xu, Uh, Uu^Uf, Xu, Xu, Gll^Fp, Gll^Fdw, Gll^Fp, Gd^Fp, Gll^Fp, Gll^Fdw, Gll^Fp, Gll, Ss, Gll^Fp, Gll^Fp, Gll^Fp
Wwg, Wwg, Wwg^Edb, Wog^Edb, Wog, Xu, Xu, Xu, Uu^Uf, Uu^Emf, Uh, Xu, Xu, Uu^Uf, Uue^Emf, Xu, Xu, Gd^Fdw, Gd^Emf, Gd^Fdw, Gll^Em, Gll^Fmw, Gll^Fmw, Gll^Fp, Gll^Fdw, Gll^Emf, Gll^Fp, Gll^Fdw, Gll
Wwg, Wwg^Edb, Wwg^Edb, Wog^Edb, Wog^Edb, Xu, Xu, Xu, Xu, Xu, Uu^Em, Uh, Uu, Xu, Uue^Em, Uue^Uf, Xu, Gd^Em, Gd^Em, Gd^Fmw, Gd^Fmw, Gll^Fmw, Gll^Fp, Gll^Fp, Gll^Fp, Gll^Fp, Gll^Fmw, Gll^Fp, Gll
Ss, Wwg^Edb, Ss^Em, Wwg, Wwg^Edb, Wwg, Xu, Xu, Uu^Emf, Uu^Uf, Xu, Xu, Ur^Es, Uu, Xu, Uue^Em, Uh, Uue^Em, Gll^Fdw, Gd^Fdw, Gd^Fmw, Gll^Fdw, Gll^Fp, Gd^Fetd, Gll^Fp, Gll^Fmw, Gll^Fp, Gll^Fmw, Gll^Fp
Gg, Ss, Ss^Emf, Ss^Vhs, Wwg, Wwg^Edb, Ss^Em, Xu, Xu, Uu^Em, Uu^Em, Uu, Xu, Ur^Es, Uue^Em, Xu, Xu, Uu, Gd^Em, Gll^Em, Gd^Fdw, Gll^Fmw, Gll^Fmw, Gll^Fp, Gll^Fmw, Gll^Fmw, Gll^Fmw, Gll^Fmw, Gll^Fp
Ss^Emf, Ss, Sm^Em, Gll^Fdw, Gll^Fdw, Wwg, Rb, Ss^Emf, Xu, Xu, Uh^Emf, Uh^Em, Xu, Uu^Emf, Uue^Em, Xu, Uh, Xu, Uu, Gd^Fdw, Gll^Emf, Gll^Fmw, Gll^Fmw, Gll^Fp, Gll^Em, Gll^Fmw, Gd^Fmw, Gll^Emf, Gll^Fdw
Gll, Ss^Em, Sm^Em, Sm^Uf, Gll^Fdw, Rb^Es, Ss^Em, Ss^Em, Ss, Xu, Uh, Uu, Ur^Es, Xu, Ur^Es, Xu, Ur^Edb, Uue^Em, Xu, Gd^Em, Gd^Em, Gll^Fdw, Gd^Fmw, Gd^Fmw, Gd^Fdw, Gd^Fdw, Gd^Fdw, Gll^Fmw, Gll
Gll^Fdw, Ss^Em, Gll^Fdw, Sm^Emf, Gll^Fmw, Rb^Es, Rb, Ss, Rb, Ur, Uu, Uu, Xu, Uu, Xu, Ur^Edb, Xu, Uue^Em, Uue^Em, Xu, Xu, Gd^Fdw, Uu, Gd^Em, Gll^Em, Xu, Xu, Gll^Em, Xu
Gll^Fdw, Ss^Edb, Rb^Edb, Gll^Fdw, Gll^Fmw, Gll^Fp, Re^Em, Rb^Es, Ss^Emf, Ss^Em, Ur, Xu, Uu^Uf, Uh^Emf, Xu, Xu, Ur, Uue^Em, Uu^Emf, Uu^Uf, Uue^Emf, Uue^Uf, Xu, Xu, Xu, Xu, Xu, Xu, Xu
Ss, Sm^Emf, Sm^Em, Rb^Edb, Gll^Fmw, Ss^Emf, Re^Em, Rb^Es, Sm, Sm, Xu, Ur^Es, Uu, Xu, Uu^Em, Ur^Es, Xu, Xu, Uu^Em, Xu, Uue^Em, Uue, Xu, Xu, Uue^Uf, Xu, Uh^Em, Uh^Uf, Xu
Ss^Em, Ss^Uf, Sm, Sm^Em, Ss, Ss^Em, Gll^Fdw, Re, Sm, Sm^Em, Ss^Emf, Xu, Ur^Es, Xu, Uu^Edb, Ur^Edb, Xu, Uu^Uf, Xu, Uu^Em, Uue^Emf, Xu, Uue^Uf, Xu, Xu, Uue^Emf, Xu, Xu, Xu
Ss^Emf, Rb^Em, Rb^Es, Sm, Rb^Es, Rb^Es, Wwg, Re^Es, Gll^Fdw, Wwg, Ss^Em, Xu, Xu, Uu, Xu, Uu^Edb, Xu, Uu^Em, Uu^Em, Xu, Uh^Uf, Xu, Ur^Es, Uue, Uu^Em, Uu^Emf, Uu, Uh, Xu
Ss, Gll^Fdw, Rb^Es, Wwg^Edb, Wwg^Edb, Wwg, Re, Re, Gll^Edb, Wwg^Edb, Wwg^Edb, Xu, Xu, Ur^Es, Uu^Edb, Uu^Edb, Ur, Ur^Es, Ur^Es, Uh^Em, Uh^Emf, Ur, Uu, Uh^Edb, Uh^Edb, Uh^Edb, Xu, Xu, Xu
Ss, Ss^Vhs, Rb^Edb, Wwg^Edb, Rb, Wwg^Edb, Re^Edb, Wwg, Rb^Fdw, Wwg^Edb, Sm^Edb, Re^Fdw, Xu, Xu, Xu, Xu, Xu, Xu, Xu, Uu^Em, Uu^Em, Ur^Es, Xu, Xu, Xu, Uh^Edb, Ur, Xu, Xu
Ss, Ss, Ss^Bw/, Ss^Bw/, Ss, Re^Edb, Wwg^Edb, Wwg^Edb, Rb, Gll^Fdw, Sm, Gll^Fdw, Sm^Em, Xu, Xu, Xu, Ss^Em, Xu, Xu, Xu, Xu, Uu, Ur^Es, Ur^Es, Ur, Xu, Xu, Ur^Es, Uu^Emf
Ss, Chs, Ww, Ss, Rb, Re, Sm, Ss^Em, Ss^Em, Ss, Ww, Sm^Em, Ss^Vhs, Ss^Emf, Sm^Em, Ss, Sm, Ss^Em, Sm^Uf, Xu, Xu, Uu, Xu, Xu, Ur^Es, Uu, Xu, Uu^Em, Uu^Uf
Ss, Ss^Emf, Ss^Em, Ss^Em, Ss, Ss^Em, Sm, Ss^Emf, Sm^Uf, Ss^Em, Gll^Fdw, Gll^Fdw, Ss, Rb^Fdw, Sm^Em, Rb^Fdw, Ss^Em, Sm^Em, Sm^Emf, Xu, Xu, Ur^Es, Xu, Ur, Xu, Xu, Rb^Es, Ur^Es, Xu
Ss^Em, Ss^Uf, Ss, Ss^Em, Ss, Sm^Em, Gll^Fdw, Sm^Uf, Gll^Fdw, Sm, Ss^Em, Gll^Fdw, Ss^Em, Sm^Emf, Ss^Em, Gll^Fdw, Ss, Sm^Em, Sm, Sm^Em, Rb, Rb^Es, Rb^Es, Rb, Ur, Ur, Rb^Es, Xu, Xu
Gll^Fdw, Ss^Em, Rb^Es, Gll^Fdw, Ww, Ss^Em, Ss^Emf, Ww, Ww, Gll^Fdw, Sm, Sm, Ss, Ss^Em, Sm^Edb, Ss^Em, Sm^Em, Sm, Ss, Ss^Em, Ss, Xu, Xu, Rb, Xu, Rb, Rb^Edb, Xu, Xu
Ss, Sm^Em, Sm, Ww, Ss^Em, Ss^Uf, Ss^Em, Chr, Re^Es, Re^Es, Rb^Es, Wwg, Wwg^Edb, Sm, Sm^Edb, Ss^Em, Ss, Sm, Ss^Em, Ss, Sm, Ss, Sm, Sm, Ss, Xu, Wwg, Wwg^Edb, Wwg^Edb
Sm^Emf, Sm^Em, Sm^Em, Chs, Chs, Ss^Em, Wwrg, 1 Chw, Chw, Wwg, Wog, Wog, Wwg^Edb, Rb^Edb, Rb^Edb, Sm^Edb, Ss^Em, Re^Fdw, Re^Fdw, Gll^Fdw, Gll^Fdw, Sm, Wwg^Edb, Sm, Ss^Em, Ss, Ss^Em, Ss^Em, Wwg^Edb
Ss^Em, Ss^Em, Rb^Es, Sm, Chs, Chw, Wwrg, Wwg, Wwg, Wog, Wog, Wog, Wwg^Edb, Rb^Edb, Gll^Fdw, Ss, Re^Fdw, Ss^Em, Ss^Emf, Gll^Fmw, Rb^Edb, Wwg, Wwg^Edb, Ss^Em, Ss^Uf, Wwg, Gll^Fdw, Ss^Em, Wwg
Gll^Fdw, Gll^Fdw, Rb^Vhr, Wwg, Wwg, Wwrg, Wwg^Edb, Wog^Edb, Wog^Edb, Wog^Edb, Wog, Wwg, Wwrg, Rb^Edb, Rb^Edb, Gll^Fmw, Re^Fdw, Ss^Em, Chw, Chw, Wwg^Edb, Wwg^Edb, Wwg^Edb, Ss^Em, Ss^Em, Ss^Emf, Ss, Gll^Fdw, Ss^Em
Wwg, Wwg^Edb, Wwg^Edb, Wwg, Wog, Wog, Wog^Edb, Wog^Edb, Wog^Edb, Wwg^Edb, Wwg, Wwrg, Wwrg, Ss^Em, Sm^Em, Gll^Fdw, Wwg, Chw, Chw, Wwg^Edb, Wwg^Edb, Wwrg, Wwg, Gll^Fdw, Re^Fdw, Re^Fdw, Ss^Em, Ss^Uf, Ss^Em
Wog^Edb, Wwrg, Wwrg, Wwg, Wog, Wog^Edb, Wog, Wog^Edb, Chw, Wwg, Wwrg, Gll^Fdw, Ss^Em, Ss, Gll^Fdw, Sm^Em, Wwrg, Wwrg, Wwg^Edb, Wwg^Edb, Wwg^Edb, Wwg^Edb, Wwg, Wwg, Gll^Fdw, Re^Fdw, Ss, Ss^Em, Ss^Emf
Wog^Edb, Wog^Edb, Wwrg, Wwrg, Wwg, Wog, Wog, Chw, Chs, Ss^Em, Gll^Fdw, Gll^Fdw, Ss^Emf, Re^Fdw, Wwg^Edb, Sm^Edb, Sm^Edb, Wwrg, Wwg^Edb, Wwg^Edb, Wwg, Wwg^Edb, Wwg^Edb, Wwg, Chs, Rb^Edb, Rb^Edb, Wwg, Gll^Fdw
Wwg^Edb, Wwg^Edb, Wwg, Wwg, Wwrg, Wog, Wwg^Edb, Chw, Gll^Fdw, Chs, Ss^Emf, Rb^Es, Ss^Uf, Sm^Em, Wwg, Sm, Sm^Edb, Wwg, Wwrg, Wwg, Wwrg, Wwrg, Wwrg, Chs, Ss^Uf, Gll^Fdw, Re^Es, Gll^Fdw, Rb^Edb
Wwg, Wwg^Edb, Wwg, Wwrg, Wwg, Wog^Edb, Wwg, Wwrg, Sm, Sm, Gg, Re^Fdw, Ss, Ss^Uf, Ss, Wwg, Wwg, Wwrg, Wwg, Wwg, Wwg, Wwg, Gg, Ss, Ss, Gll^Fdw, Re^Es, Rb^Edb, Re^Es
