Gg, Wwg, Gg, Gg, Wwg, Wwg, Wog, Wwg, Wog, Wwg, Xu, Uu^Uf, Uu^Uf, Uu, Xu, Uu, Uu^Uf, Uu, Uu^Uf, Xu, Xu, Gll^Fp, Gll^Fp, Gll^Fp, Gll^Fp, Gll^Fp, Gll^Fp, Gll^Fp, Gll^Fp, Ss, Gll^Fp, Gll^Fp, Gll^Fp
Gg, Wwg, Wwg, Gg, Gg, Wwg, Wwg^Edb, Wog^Edb, Wog, Wwg, Xu, Uu^Uf, Xu, Uu, Uu, Xu, Xu, Uu^Uf, Uu, Xu, Xu, Gll^Fp, Gll^Fp, Gll^Fp, Gll^Fp, Gll^Fp, Gll^Fp, Gll^Fp, Gll^Fp, Gll^Fp, Gll^Fp, Gll^Fp, Gll^Fp
Wwg, Wwg, Wwg, Wwg, Wwg, Wwg^Edb, Wwg^Edb, Wog^Edb, Wog^Edb, Wwg, Xu, Uu, Uu, Xu, Uu, Uh, Uu, Xu, Uu, Uu^Uf, Xu, Gll^Fp, Gll^Fp, Gll^Fp, Gll^Fp, Gll^Fp, Gll^Fp, Gll^Fp, Gll^Fp, Gll^Fp, Gll^Fp, Gll^Fp, Gll^Fp
Ss, Ss, Ss, Ss, Gg, Wwg^Edb, Wwg, Wwg, Wwg^Edb, Mm, Xu, Uu^Uf, Ur, Uu^Uf, Xu, Xu, Ur, Uu, Xu, Uu, Uh, Gll^Fp, Gll^Fp, Gll^Fp, Gll^Fp, Gll^Fp, Gll^Fp, Gd^Fetd, Gll^Fp, Gll^Fp, Gll^Fp, Gll^Fp, Gll^Fp
Gs^Fp, Ss, Ss, Ss, Gg, Gg, Gg, Ss^Vhs, Wwg, Wwg^Edb, Ss, Xu, Xu, Ur, Ur, Ur, Xu, Ur, Ur, Xu, Xu, Gll^Fp, Gll^Fp, Gll^Fp, Gll^Fp, Gll^Fp, Gll^Fp, Gll^Fp, Gll^Fp, Gll^Fp, Gll^Fp, Gll^Fp, Gll^Fp
Ss, Ss, Ss, Ss, Ss, Ss, Ss, Gs^Fp, Gs^Fp, Wwg, Re, Re, Xu, Xu, Uh, Uh, Xu, Uu^Uf, Ur, Xu, Uh, Xu, Gll^Fp, Gll^Fp, Gll^Fp, Gll^Fp, Gll^Fp, Gll^Fp, Gll^Fp, Gll^Fp, Gll^Fp, Gll^Fp, Gll^Fp
Ss, Ss, Ss, Ss, Gg, Ss, Ss, Gs^Fp, Gs^Fp, Re, Ss, Ss, Ss, Xu, Uh, Ur, Ur, Xu, Ur, Xu, Ur, Ur, Xu, Gll^Fp, Gll^Fp, Gll^Fp, Gll^Fp, Gll^Fp, Gll^Fp, Gll^Fp, Gll^Fp, Gll^Fp, Gll^Fp
Wwg, Ss, Ss, Gg, Hh, Ss, Gs^Fp, Gs^Fp, Gs^Fp, Re, Re, Ss, Ss, Ur, Ur, Ur, Xu, Ur, Xu, Ur, Xu, Uu, Uu^Uf, Xu, Uu, Gll^Fp, Gll^Fp, Gll^Fp, Gll^Fp, Xu, Xu, Gll^Fp, Xu
Wwg, Gs^Fp, Ss, Ss, Gg, Ss, Ss, Gs^Fp, Gs^Fp, Gs^Fp, Re, Ss, Ss, Ss, Uu, Xu, Uu, Uh, Xu, Xu, Uu, Uu, Uu^Uf, Xu, Uu, Uu^Uf, Uu^Uf, Xu, Xu, Xu, Uue, Xu, Uue
Wwg, Gs^Fp, Ss, Ss, Ss, Ss, Ss, Gs^Fp, Gs^Fp, Gs^Fp, Re, Gg, Gg, Xu, Xu, Ur, Ur, Xu, Uu^Uf, Uu^Uf, Xu, Xu, Uu, Xu, Uu, Uu, Xu, Xu, Uu^Uf, Xu, Uue, Uue, Uue
Wwg, Wwg, Gs^Fp, Ss, Ss, Ss, Ss, Ss, Ss, Ss, Gg, Re, Gg, Ss, Ss, Xu, Ur, Xu, Ur, Ur, Xu, Uu^Uf, Xu, Uu, Uu^Uf, Xu, Uu^Uf, Xu, Xu, Uu^Uf, Xu, Xu, Xu
Wwg, Wwg, Gs^Fp, Ss, Ss, Gg, Gg, Gg, Gg, Gg, Gg, Re, Gg, Gg, Gg, Xu, Ur, Uu, Xu, Uu, Xu, Uu, Uu, Xu, Uh, Xu, Ur, Uu, Uu, Uu, Uu, Uu, Uu^Uf
Gs^Fp, Gs^Fp, Gs^Fp, Ss, Ss, Gg, Gg, Wwg, Wwg, Gg, Re, Re, Gg, Wwg, Gg, Xu, Xu, Ur, Uu, Uu, Ur, Ur, Ur, Uh, Uh, Ur, Uu, Uh, Uh, Uh, Xu, Xu, Xu
Gs^Fp, Ss, Ss, Ss, Ss, Ss^Vhs, Gg, Wwg, Gg, Gg, Re, Wwg, Gg, Wwg, Gg, Gg, Xu, Ur, Ur, Ur, Xu, Xu, Xu, Uu, Uu, Uu, Xu, Xu, Xu, Uh, Uu, Uu^Uf, Uu^Uf
Ss, Ss, Ss, Ss, Ss, Ss, Ss^Bw/, Re, Re, Gg, Wwg, Wwg, Gg, Gg, Ss, Ss, Ss, Xu, Xu, Xu, Ss, Sm, Sm, Xu, Xu, Ur, Ur, Ur, Uu, Xu, Xu, Uu, Uu^Uf
Ss, Ss, Ss, Ss, Chs, Ss^Bw/, Ss, Gg, Gg, Re, Ss, Ss, Ss, Ss, Ss, Ss, Ss^Vhs, Ss, Gg, Ss, Sm, Ss, Sm, Sm, Xu, Uu, Xu, Xu, Uu, Uu, Xu, Uu, Uu^Uf
Hh, Ss, Chs, Chs, Ss, Ss, Ss, Ss, Ss, Ss, Ss, Ss, Ss, Ss, Ss, Ss, Ss, Gg, Gg, Ss, Ss, Sm, Sm, Sm, Sm, Uu, Xu, Ur, Xu, Xu, Ur, Ur, Xu
Ss, Ss, Ss, Chs, Ss, Ss, Ss, Ss, Ss, Ss, Gs^Fp, Ss, Gs^Fp, Ss, Ss, Ss, Ss, Ss, Ss, Gg, Ss, Sm, Sm, Sm, Gg, Uu, Uu, Ur, Ur, Uu, Uu, Xu, Ur
Ss, Ss, Ss, Ss^Bw|, Gs^Fp, Ss, Gg^Ve, Gg, Ww, Ss, Ss, Ss, Ss, Ss, Sm, Sm, Ss, Ss, Sm, Ss, Sm, Sm, Sm, Ss, Gg, Xu, Xu, Uu, Xu, Ur, Re, Ur, Uu^Uf
Hh, Ss, Sm, Ss, Ss, Ss, Ss, Sm, Ss, Ss, Ss, Chr, Re, Ss, Re, Sm, Gs^Fp, Sm, Gs^Fp, Sm, Sm, Sm, Ss, Gg, Ss, Gg, Gg, Xu, Xu, Re, Gg, Xu, Xu
Ss, Sm, Sm, Sm, Sm, Ss, Ss, Chs, Ss, Ss, Ww^Bw/, Chr, Re, 1 Gg, Re, Ss, Ss, Gs^Fp, Gs^Fp, Gs^Fp, Gs^Fp, Sm, Sm, Ss, Sm, Ss, Ss, Ss, Gg, Gg, Gg, Gg, Gg
Ss, Ss, Sm, Sm, Sm, Ss, Ss, Sm, Chs, Ww^Bw/, Ss, Ss, Ss, Re, Gg, Wwg, Wwg, Ss, Ss, Ss, Ss, Ss, Ss, Ss, Sm, Sm, Sm, Sm, Ss, Gg, Wwg, Wwg, Wwg
Ss, Ss, Ss, Sm, Sm, Sm, Sm, Sm, Chr, Gg, Wwg, Wwg, Wwg, Wwg, Wog, Wog, Wwg, Gg, Gg, Ss, Ss, Gg, Gg, Gg, Gg, Ss, Ss, Ss, Ss, Ss, Ss, Wwg, Wwg^Edb
Ss, Ss, Ss, Ss, Ss, Ss, Wwg, Ss, Gg, Wwg, Wwg, Wwg, Wwg, Wog, Wog, Wog, Wwg, Gg, Gg, Gg, Gg, Gg, Gg, Gg, Gg, Wwg, Ss, Ss, Ss, Ss, Ss, Ss, Ss
Wwg, Wwg, Gg, Gg, Gg, Gg, Gg^Ve, Wwg, Wwg, Wwg, Wwg^Edb, Wog^Edb, Wog^Edb, Wog^Edb, Wog, Wwg, Wwg, Gg, Gg, Gg, Gg, Gg, Wwg, Wwg, Wwg, Wwg, Wwg, Ss, Ss, Ss, Ss, Ss, Ss
Wwg, Wwg, Wwg, Gg, Wwg, Wwg, Wwg, Wwg, Wog, Wog, Wog^Edb, Wog^Edb, Wog^Edb, Wwg^Edb, Wwg, Wwg, Wwg, Ss, Wwg, Gg, Wwg, Wwg, Wwg, Wwg^Edb, Wwg^Edb, Wwg, Wwg, Gs^Fp, Gs^Fp, Gs^Fp, Ss, Ss, Ss
Wwg, Wog, Wog^Edb, Wwg, Wog^Edb, Wwg, Wwg, Wwg, Wog, Wog^Edb, Wog, Wog^Edb, Wwg, Wwg, Wwg, Gg, Ss, Ss, Ss, Wwg, Wwg, Wwg, Wwg^Edb, Wwg^Edb, Wwg^Edb, Wwg^Edb, Wwg, Wwg, Gs^Fp, Gs^Fp, Ss, Ss, Ss
Wwg, Wog^Edb, Wwg, Wog^Edb, Wwg, Wwg, Wwg, Wwg, Wwg, Wog, Wog, Wwg, Wwg, Ss, Ss, Gg^Ve, Ss, Ss, Ss, Wwg, Wwg, Wwg, Wwg^Edb, Wwg^Edb, Wwg, Wwg^Edb, Wwg^Edb, Wwg, Wwg, Gs^Fp, Gs^Fp, Wwg, Gs^Fp
Gg, Wwg, Wwg, Wwg, Gg, Wwg, Wwg, Wwg, Wwg, Wog, Wwg^Edb, Wwg, Gs^Fp, Ss, Ss, Gg, Ss, Ss, Ss, Ss, Wwg, Wwg, Wwg, Wwg, Wwg, Wwg, Wwg^Edb, Wwg, Ss, Gs^Fp, Gs^Fp, Gs^Fp, Gs^Fp
Gg, Gg, Wwg, Gg, Gg, Gg, Wwg, Wwg, Wwg, Wog^Edb, Wwg, Wwg, Ss, Gg, Gg, Gg, Ss, Ss, Ss, Ss, Wwg, Wwg, Gg, Gg, Gg, Wwg, Gg, Ss, Ss, Gs^Fp, Gs^Fp, Gs^Fp, Gs^Fp
