Gg, Wwg, Gg, Gg, Wwg, Wwg, Wog, Wwg, Wog, Wwg, Xu, Uu^Uf, Uu^Uf, Uu, Xu, Uu, Uu^Uf, Uu, Uu^Uf, Xu, Xu, Uu^Uf, Uu^Uf, Xu, Uh, Uh, Xu, Xu, Gll^Fp, Ss, Gll^Fp, Gll^Fp, Gll^Fp, Gll^Fp, Gll^Fp, Gll^Fp, Gll^Fp, Gll^Fp, Gll^Fp, Ss
Gg, Wwg, Wwg, Gg, Gg, Wwg, Wwg^Edb, Wog^Edb, Wog, Wwg, Xu, Uu^Uf, Xu, Uu, Uu, Xu, Xu, Uu^Uf, Uu, Xu, Xu, Uu^Uf, Xu, Xu, Uh, Xu, Uue, Xu, Gll^Fp, Gll^Fp, Gll^Fp, Gll^Fp, Gll^Fp, Gll^Fp, Gll^Fp, Gll^Fp, Gll^Fp, Gll^Fp, Gll^Fp, Gll^Fp
Wwg, Wwg, Wwg, Wwg, Wwg, Wwg^Edb, Wwg^Edb, Wog^Edb, Wog^Edb, Wwg, Xu, Uu, Uu, Xu, Uu, Uh, Uu, Xu, Uu, Uu^Uf, Xu, Uh, Xu, Uu, Uu^Uf, Xu, Uue, Xu, Xu, Gll^Fp, Gll^Fp, Gll^Fp, Gll^Fp, Gll^Fp, Gll^Fp, Gll^Fp, Gll^Fp, Gll^Fp, Gll^Fp, Gll^Fp
Ss, Ss, Ss, Ss, Gg, Wwg^Edb, Wwg, Wwg, Wwg^Edb, Wwg, Re, Uu^Uf, Ur, Uu^Uf, Xu, Xu, Ur, Uu, Xu, Uu, Uh, Uh, Uh, Uu, Xu, Uue, Uue, Uue, Xu, Gll^Fp, Gll^Fp, Gll^Fp, Gll^Fp, Gll^Fp, Gll^Fp, Gll^Fp, Gll^Fp, Gll^Fp, Gll^Fp, Gll^Fp
Gs^Fp, Ss, Ss, Ss, Gg, Gg, Gg, Ss^Vhs, Wwg, Wwg^Edb, Ss, Re, Xu, Ur, Ur, Xu, Xu, Ur, Ur, Xu, Xu, Uh, Xu, Uu, Uu, Xu, Xu, Xu, Gll^Fp, Gll^Fp, Gll^Fp, Gll^Fp, Gll^Fp, Gll^Fp, Gd^Fetd, Gll^Fp, Gll^Fp, Gll^Fp, Gll^Fp, Gll^Fp
Ss, Ss, Ss, Ss, Ss, Ss, Ss, Gs^Fp, Gs^Fp, Wwg, Re, Re, Xu, Xu, Uh, Uh, Xu, Uu^Uf, Ur, Uh, Uh, Xu, Uu^Uf, Xu, Uu, Uu^Uf, Xu, Gs^Fp, Gll^Fp, Gll^Fp, Gll^Fp, Gll^Fp, Gll^Fp, Gll^Fp, Gll^Fp, Gll^Fp, Gll^Fp, Gll^Fp, Gll^Fp, Gll^Fp
Ss, Ss, Ss, Ss, Gg, Ss, Ss, Gs^Fp, Gs^Fp, Re, Ss, Ss, Ss, Xu, Uh, Ur, Xu, Xu, Ur, Xu, Ur, Ur, Xu, Ur, Uu, Uue, Uue, Uue, Gll^Fp, Gll^Fp, Gll^Fp, Gll^Fp, Gll^Fp, Gll^Fp, Gll^Fp, Gll^Fp, Gll^Fp, Gll^Fp, Gll^Fp, Gll^Fp
Wwg, Ss, Ss, Gg, Hh, Ss, Gs^Fp, Gs^Fp, Gs^Fp, Re, Re, Ss, Ss, Xu, Ur, Ur, Xu, Ur, Xu, Ur, Xu, Uu, Uu^Uf, Xu, Uu, Xu, Xu, Xu, Gll^Fp, Gll^Fp, Gll^Fp, Gll^Fp, Gll^Fp, Gll^Fp, Gll^Fp, Gll^Fp, Gll^Fp, Gll^Fp, Gll^Fp, Gll^Fp
Wwg, Gs^Fp, Ss, Ss, Gg, Ss, Ss, Gs^Fp, Gs^Fp, Gs^Fp, Re, Ss, Ss, Xu, Uu, Xu, Uu, Uh, Xu, Xu, Uu, Uu, Uu^Uf, Xu, Uu, Uu^Uf, Xu, Uue, Uue, Xu, Xu, Gll^Fp, Xu, Gll^Fp, Gll^Fp, Gll^Fp, Gll^Fp, Gll^Fp, Gll^Fp, Gll^Fp
Wwg, Gs^Fp, Ss, Ss, Ss, Ss, Ss, Gs^Fp, Gs^Fp, Gs^Fp, Re, Gg, Gg, Xu, Xu, Ur, Ur, Xu, Uu^Uf, Uu^Uf, Xu, Xu, Uu, Xu, Uu, Uu, Uue, Uue, Xu, Uue, Xu, Xu, Uu^Uf, Xu, Gll^Fp, Xu, Xu, Gll^Fp, Xu, Ss
Wwg, Wwg, Gs^Fp, Ss, Ss, Ss, Ss, Ss, Ss, Ss, Gg, Re, Gg, Ss, Ss, Xu, Ur, Xu, Ur, Ur, Xu, Uu^Uf, Xu, Uu, Uu^Uf, Uu^Uf, Uu, Uu^Uf, Xu, Uue, Uu, Uu^Uf, Uu^Uf, Xu, Xu, Xu, Uue, Xu, Uue, Xu
Wwg, Wwg, Gs^Fp, Ss, Ss, Gg, Gg, Gg, Gg, Gg, Gg, Re, Gg, Gg, Gg, Xu, Ur, Uu, Xu, Uu, Xu, Uu, Uu, Xu, Xu, Xu, Uu, Xu, Uu, Uu, Xu, Uu^Uf, Xu, Xu, Uu^Uf, Xu, Uue, Uue, Uue, Uue
Gs^Fp, Gs^Fp, Gs^Fp, Ss, Ss, Gg, Gg, Gg, Gg, Gg, Re, Re, Gg, Wwg, Gg, Xu, Xu, Ur, Uu, Uu, Ur, Ur, Ur, Uh, Uh, Uu, Uu, Uu, Xu, Uh, Uh, Xu, Uu^Uf, Xu, Xu, Uu^Uf, Xu, Xu, Uu, Uu^Uf
Gs^Fp, Ss, Ss, Ss, Ss, Ss^Vhs, Gg, Gg, Gg, Gg, Re, Gg, Gg, Wwg, Gg, Gg, Xu, Ur, Ur, Ur, Xu, Xu, Xu, Uu, Uu, Xu, Xu, Xu, Uh, Xu, Uh, Xu, Ur, Uu, Uu, Uu, Uu, Uu, Uu^Uf, Uu^Uf
Ss, Ss, Ss, Ss, Ss, Ss, Ss^Bw/, Re, Re, Gg, Re, Gg, Gg, Gg, Ss, Ss, Ss, Xu, Xu, Xu, Ss, Sm, Sm, Xu, Xu, Ur, Ur, Uh, Uh, Xu, Xu, Ur, Uu, Uh, Uh, Uh, Xu, Xu, Xu, Uu
Ss, Ss, Ss, Ss, Chs, Ss^Bw/, Ss, Gg, Gg, Re, Ss, Ss, Ss, Ss, Ss, Ss, Ss^Vhs, Ss, Gg, Ss, Sm, Ss, Sm, Sm, Xu, Uu, Ur, Xu, Uu^Uf, Uh, Uh, Uu, Xu, Xu, Xu, Uh, Uu, Uu^Uf, Uu^Uf, Xu
Hh, Ss, Chs, Chs, Ss, Ss, Ss, Ss, Ss, Ss, Ss, Ss, Ss, Ss, Ss, Ss, Ss, Gg, Gg, Ss, Ss, Sm, Sm, Sm, Xu, Uu, Uu, Xu, Xu, Uu^Uf, Xu, Ur, Ur, Ur, Uu, Xu, Xu, Uu, Uu^Uf, Uu^Uf
Ss, Ss, Ss, Chs, Ss, Ss, Ss, Ss, Ss, Ss, Gs^Fp, Ss, Gs^Fp, Ss, Ss, Ss, Ss, Ss, Ss, Gg, Ss, Sm, Sm, Sm, Gg, Xu, Uu, Ur, Xu, Xu, Uu, Uu, Xu, Xu, Uu, Uu, Xu, Uu, Uu^Uf, Xu
Ss, Ss, Ss, Ss^Bw|, Re, Ss, Ss, Gg, Gg, Ss, Ss, Ss, Ss, Ss, Sm, Sm, Ss, Ss, Sm, Ss, Sm, Sm, Sm, Ss, Gg, Xu, Xu, Ur, Ur, Ur, Ur, Uu, Xu, Ur, Xu, Xu, Ur, Ur, Xu, Xu
Ss, Ss, Gs^Fp, Re, Gs^Fp, Re, Re, Re, Re, Ss, Ss, Gs^Fp, Ss, Sm, Ss, Sm, Ss, Sm, Sm, Sm, Sm, Sm, Ss, Gg, Ss, Gg, Gg, Xu, Xu, Xu, Xu, Uu, Uu, Ur, Ur, Uu, Uu, Xu, Ur, Uu^Uf
Ss, Ss, Ss, Ss, Gs^Fp, Ss, Gg, Gg, Re, Ss, Ss, Gs^Fp, Ss, Ss, Sm, Sm, Sm, Ss, Sm, Ss, Ss, Sm, Sm, Ss, Sm, Ss, Ss, Ss, Gg, Gg, Gg, Xu, Xu, Uu, Xu, Ur, Re, Ur, Uu^Uf, Uu^Uf
Ss, Ss, Ss, Ss, Gs^Fp, Ss, Gg^Ve, Ww, Ww, Re, Ss, Gs^Fp, Ss, Ss, Sm, Sm, Sm, Sm, Sm, Sm, Gs^Fp, Ss, Ss, Ss, Sm, Sm, Sm, Sm, Ss, Gg, Wwg, Wwg, Wwg, Xu, Wwg, Re, Gg, Xu, Xu, Xu
Hh, Ss, Ss, Ss, Ss, Ss, Re, Ww, Re, Re, Gs^Fp, Gs^Fp, Ss, Ss, Ss, Sm, Ss, Sm, Ss, Sm, Ss, Ss, Ss, Ss, Sm, Ss, Ss, Sm, Ss, Ss, Wwg, Wwg, Wwg^Edb, Wwg^Edb, Wwg^Edb, Re, Gg, Gg, Gg, Gg
Gg, Ss^Vhs, Re, Gg, Re, Re, Gg, Re, Ss, Ww, Gs^Fp, Gs^Fp, Ss, Ss, Ss, Ss, Ss, Ss, Ss, Ss, Ss, Ss, Ss, Ss, Ss, Ss, Ss, Ss^Vhs, Wwg, Ss, Wwg, Wwg, Wwg^Edb, Wwg^Edb, Re, Re, Gg, Gg, Gg, Gg
Re, Re, Gg, Re, Re, Gg, Gg, Ss, Gs^Fp, Gs^Fp, Gs^Fp, Ss, Ss, Ss, Ss, Ss, Ss, Ss, Ss, Ss, Ss, Gg, Gg, Ss, Ss, Ss, Ss, Wwg, Wwg, Wwg, Ss, Wwg, Wwg^Edb, Re, Gg, Gg, Gg, Gg, Gg, Gg
Gg, Gg, Gg, Gg, Re, Gg, Ss, Ss, Gs^Fp, Gs^Fp, Gs^Fp, Ss, Ss, Ss, Ss, Ss, Ss, Gs^Fp, Ss, Ss, Ss, Gg, Gg, Gg, Gg, Ss, Ss, Ss, Ss, Ss, Wwg, Wwg, Ss, Re, Gg, Ss, Ss, Ss, Ss, Ss
Ss, Ss, Gg, Gg, Gg, Re, Ww^Bw\, Ss, Chs, Ss, Ss, Ss, Ss, Ss, Gg, Ss, Gs^Fp, Gs^Fp, Gs^Fp, Ss, Ss, Gg, Gg, Gg, Gg, Ss, Ss, Ss, Ss, Wwg, Wwg, Ss, Re, Re, Ss, Ss, Ss, Ss, Ss, Ss
Ss, Ss, Ss, Gg, Gg, Gg, Ss, Chs, Ss, Chs, Ss, Ss, Ss, Ss, Gg, Ss, Gs^Fp, Gg^Ve, Gs^Fp, Gs^Fp, Ss, Ss, Gg, Gg, Gg, Ss, Ss, Ss, Ss, Wwg, Ss, Re, Gg, Gg, Ss, Ss, Ss, Ss, Ss, Ss
Ss, Ss, Ss, Gg, Ss, Gg, Ss, Ss, Ss, Chs, Ww^Bw\, Ss, Ss, Gg, Gg, Ss, Gs^Fp, Gs^Fp, Gs^Fp, Gs^Fp, Ss, Ss, Ss, Gg, Gg, Ss, Ss, Ss, Wwg, Wwg, Ss, Re, Gg, Gg, Gg, Gg, Ss, Ss, Ss, Ss
Ss, Ss, Ss, Gg, Ss, Ss, Ss, Ss, Ss^Vhs, Ss, Ss, Ww^Bw\, Re, Gg, Gg, Ss, Gs^Fp, Gs^Fp, Gs^Fp, Gs^Fp, Gs^Fp, Gs^Fp, Chr, Gg, Gg, Ss, Ss, Ss, Wwg, Ss, Gg, Re, Gg, Gg, Gg, Gg, Gg, Ss, Ss, Wwg
Ss, Ss, Sm, Ss, Sm, Sm, Sm, Ss, Ss, Ss, Gg, Gg, Gg, Re, Gg, Ss, Gs^Fp, Gs^Fp, Re, Gs^Fp, Re, Re, Ss, Re, Re, Ss, Ss, Ss, Wwg, Wwg, Wwg, Re, Gg, Ss, Ss, Gg, Gg, Ss, Wwg, Wwg
Ss, Sm, Ss, Sm, Sm, Sm, Sm, Sm, Sm, Ss, Ss, Gg, Gg, Re, Ss, Ss, Re, Re, Gs^Fp, Re, Gs^Fp, Gs^Fp, Ss, Gg, Gg, Re, Re, Re, Re, Re, Re, Re, Gg, Ss, Ss, Ss, Ss, Ss, Wwg, Wog
Ss, Ss, Sm, Ss, Sm, Ss, Ss, Ss, Sm, Ss, Ss, Ss, Gg, Re, Re, Ss, Re, Gs^Fp, Gs^Fp, Gs^Fp, Gs^Fp, Gs^Fp, Ss, Gg, Gg, Ss, Ss, Ss^Vhs, Ss, Ss, Gg, Gg, Gg, Ss, Ss, Ss, Ss^Vhs, Wwg, Wwg, Wog
Ss, Sm, Sm, Sm, Sm, Ss, Sm, Sm, Ss, Ss, Ss, Ss, Gg, Gg, Re, Ww^Bw/, Gs^Fp, Gs^Fp, Gs^Fp, Gs^Fp, Gs^Fp, Gs^Fp, Ss, Gg, Gg, Ss, Ss, Ss, Ss, Ss, Gg, Gg, Gg, Ss, Ss, Ss, Wwg, Wwg, Wwg, Wog
Ss, Sm, Sm, Ss, Ss, Ss, Sm, Sm, Ss, Ss, Ss, Ss, Gg, Gg, Re, Ss, Gs^Fp, Gg^Ve, Gs^Fp, Gs^Fp, Gs^Fp, Ss, Ss, Gg, Ss, Ss, Gs^Fp, Gs^Fp, Ss, Ss, Gg, Gg, Ss, Ss, Gg, Gg, Ss, Wwg, Wwg, Wwg
Ss, Sm, Sm, Sm, Sm, Ss, Ss, Ss, Ss, Ss, Ww^Bw/, Chr, Re, Gg, Re, Ss, Ss, Gs^Fp, Gs^Fp, Gs^Fp, Gs^Fp, Ss, Gg, Gg, Ss, Ss, Gs^Fp, Gs^Fp, Ss, Ss, Gg, Gg, Gg, Gg, Gg, Gg, Gg, Ss, Ss, Ss
Ss, Ss, Sm, Sm, Sm, Ss, Chs, Chs, Chs, Ww^Bw/, Ss, Ss, Ss, Re, Gg, Wwg, Wwg, Ss, Ss, Ss, Ss, Ss, Gg, Gg, Ss, Ss, Ss, Ss, Ss, Ss, Gg, Gg, Gg, Gg, Gg, Gg, Gg, Gg, Gg, Gg
Ss, Ss, Ss, Sm, Sm, Ss, Chs, 1 Khr, Chr, Gg, Wwg, Wwg, Wwg, Wwg, Wog, Wog, Wwg, Gg, Gg, Ss, Ss, Gg, Gg, Gg, Gg, Ss, Ss, Ss, Ss, Ss, Ss, Ss, Ss, Ss, Ss, Ss, Ss, Ss, Gg, Gg
Ss, Ss, Ss, Ss, Ss, Ss, Gg, Chr, Gg, Wwg, Wwg, Wwg, Wwg, Wog, Wog, Wog, Wwg, Gg, Gg, Gg, Gg, Gg, Gg, Gg, Gg, Wwg, Ss, Ss, Ss, Ss, Ss, Ss, Ss, Ss, Ss, Ss, Ss, Ss, Hh, Hh
Wwg, Wwg, Gg, Gg, Gg, Gg, Gg^Ve, Wwg, Wwg, Wwg, Wwg^Edb, Wog^Edb, Wog^Edb, Wog^Edb, Wog, Wwg, Wwg, Gg, Gg, Gg, Gg, Gg, Wwg, Wwg, Wwg, Wwg, Wwg, Ss, Ss, Ss, Ss, Ss, Ss, Ss^Vhs, Ss, Ss, Ss, Ss, Hh, Hh
Wwg, Wwg, Wwg, Gg, Wwg, Wwg, Wwg, Wwg, Wog, Wog, Wog^Edb, Wog^Edb, Wog^Edb, Wwg^Edb, Wwg, Wwg, Wwg, Ss, Wwg, Gg, Wwg, Wwg, Wwg, Wwg^Edb, Wwg^Edb, Wwg, Wwg, Gs^Fp, Gs^Fp, Gs^Fp, Ss, Ss, Ss, Gs^Fp, Ss, Ss, Gs^Fp, Hh, Hh, Hh
Wwg, Wog, Wog^Edb, Wwg, Wog^Edb, Wwg, Wwg, Wwg, Wog, Wog^Edb, Wog, Wog^Edb, Wwg, Wwg, Wwg, Gg, Ss, Ss, Ss, Wwg, Wwg, Wwg, Wwg^Edb, Wwg^Edb, Wwg^Edb, Wwg^Edb, Wwg, Wwg, Gs^Fp, Gs^Fp, Ss, Ss, Ss, Gs^Fp, Gs^Fp, Ss, Gs^Fp, Hh, Hh, Hh
Wwg, Wog^Edb, Wwg, Wog^Edb, Wwg, Wwg, Wwg, Wwg, Wwg, Wog, Wog, Wwg, Wwg, Ss, Ss, Gg^Ve, Ss, Ss, Ss, Wwg, Wwg, Wwg, Wwg^Edb, Wwg^Edb, Wwg, Wwg^Edb, Wwg^Edb, Wwg, Wwg, Gs^Fp, Gs^Fp, Wwg, Gs^Fp, Gs^Fp, Ss, Ss, Ss, Hh, Hh, Mm
Gg, Wwg, Wwg, Gg, Gg, Gg, Wwg, Wwg, Wwg, Wog, Wwg^Edb, Wwg, Gs^Fp, Ss, Ss, Gg, Ss, Ss, Ss, Ss, Wwg, Wwg, Wwg, Wwg, Wwg, Wwg, Wwg^Edb, Wwg, Ss, Gs^Fp, Gs^Fp, Gs^Fp, Gs^Fp, Ss, Ss, Hh, Hh, Ss, Hh, Hh
Gg, Gg, Wwg, Gg, Gg, Gg, Wwg, Wwg, Wwg, Wog^Edb, Wwg, Wwg, Ss, Gg, Gg, Gg, Ss, Ss, Ss, Ss, Wwg, Wwg, Gg, Gg, Gg, Gg^Ve, Gg, Ss, Ss, Gs^Fp, Gs^Fp, Gs^Fp, Gs^Fp, Ss, Hh, Mm, Hh, Hh, Mm, Ww
Ss, Gg, Gg, Gg, Gg, Gg, Wwg, Wwg, Wwg, Wog, Wwg, Wwg, Ss, Gg, Gg, Gg, Ss, Ss, Ss, Ss, Wwg, Ss, Gg, Gg, Gg, Gg, Gg, Ss, Ss, Gs^Fp, Gs^Fp, Gs^Fp, Ss, Hh, Hh, Hh, Ww, Wwg, Hh, Ww
