Gll^Fp, Gll, Gd^Fmw, Gll^Fp, Re^Es, Gll^Fp, Gd^Fmw, Gll^Fp, Gll^Emf, Gll^Fp, Xu, Xu, Xu, Xu, Xu, Xu, Xu, Xu, Xu, Xu, Xu, Xu, Wwg, Wwg, Wwg, Xu, Xu, Xu, Xu, Xu, Xu, Xu, Xu, Xu, Xu, Uu, Xu, Xu, Wwg, Wwg, Wwg, Xu, Xu, Xu, Xu, Xu, Xu, Xu, Xu, Xu, Xu, Xu, Xu, Xu, Xu, Xu, Xu, Xu, Xu, Xu, Xu, Xu, Xu, Xu, Xu, Xu, Xu, Xu, Xu, Xu, Xu, Xu, Xu, Xu, Xu, Xu
Gll^Fp, Gll^Fmw, Gd^Fmw, Gd^Fp, Gll^Fmw, Re, Gd^Fp, Gll^Fp, Gll^Em, Gll^Em, Gll^Fmw, Xu, Xu, Xu, Xu, Xu, Xu, Xu, Xu, Xu, Xu, Wwg, Wwg, Wwg, Xu, Xu, Xu, Xu, Xu, Xu, Xu, Xu, Xu, Xu, Xu, Xu, Wwg, Wwg, Xu, Xu, Xu, Xu, Xu, Xu, Xu, Xu, Xu, Xu, Xu, Xu, Xu, Xu, Xu, Xu, Xu, Xu, Xu, Xu, Xu, Xu, Xu, Xu, Xu, Xu, Xu, Xu, Xu, Xu, Xu, Xu, Xu, Xu, Xu, Xu, Xu, Xu
Gll^Em, Gll^Emf, Gd^Fp, Gll^Fmw, Gd^Em, Re^Es, Re^Es, Gd^Fmw, Gd^Fmw, Gll^Fp, Gll^Fmw, Xu, Xu, Xu, Xu, Xu, Xu, Xu, Xu, Xu, Wwg^Xo, Wwg^Xo, Xu, Xu, Xu, Xu, Xu, Xu, Xu, Xu, Xu, Xu, Xu, Xu, Xu, Wwg, Wwg, Xu, Xu, Xu, Xu, Xu, Xu, Xu, Xu, Xu, Xu, Xu, Xu, Xu, Xu, Xu, Xu, Xu, Xu, Xu, Xu, Xu, Xu, Xu, Xu, Xu, Xu, Xu, Xu, Xu, Xu, Xu, Xu, Xu, Xu, Xu, Xu, Xu, Xu, Xu
Gll^Emf, Gll^Fp, Gll^Fmw, Gd^Fp, Gll^Fmw, Gd^Em, Re, 1 Rb, Rb, Gll^Fmw, Gd^Fdw, Rb^Es, Xu, Xu, Xu, Xu, Xu, Xu, Xu, Xu, Wwrg, Xu, Xu, Xu, Xu, Xu, Xu, Xu, Xu, Xu, Xu, Xu, Xu, Xu, Xu, Wwg, Wwg, Wwg, Xu, Xu, Xu, Xu, Xu, Xu, Xu, Xu, Xu, Xu, Xu, Xu, Xu, Xu, Xu, Xu, Xu, Xu, Xu, Xu, Xu, Xu, Xu, Xu, Xu, Xu, Xu, Xu, Xu, Xu, Xu, Xu, Xu, Xu, Xu, Xu, Xu, Xu
Gll^Fp, Gll^Fp, Gll^Em, Gll^Fp, Gll^Fp, Gll^Fmw, Gd^Fdw, Re^Es, Rb^Es, Gll^Fmw, Rb, Rb^Es, Xu, Xu, Xu, Xu, Xu, Xu, Xu, Xu, Wwrg, Xu, Xu, Xu, Xu, Xu, Xu, Xu, Xu, Xu, Xu, Xu, Xu, Xu, Xu, Wwg^Xo, Xu, Xu, Xu, Xu, Xu, Xu, Xu, Xu, Xu, Xu, Xu, Xu, Xu, Xu, Ql, Ql, Ql, Ql, Ql, Ql, Ql, Ql, Ql, Xu, Xu, Xu, Xu, Xu, Xu, Xu, Xu, Xu, Xu, Xu, Xu, Xu, Xu, Xu, Xu, Xu
Wwg, Wwg^Ewl, Wwg, Wwg^Ewl, Wwg^Ewl, Gll^Fmw, Gll^Fdw, Gd^Fdw, Rb, Gd^Fdw, Gll^Fdw, Uu, Uu, Xu, Uu, Uu, Uu, Xu, Xu, Wwrg, Wwrg, Xu, Xu, Xu, Xu, Xu, Xu, Xu, Xu, Xu, Xu, Xu, Xu, Xu, Wwg, Wwg^Xo, Xu, Xu, Xu, Xu, Xu, Xu, Xu, Xu, Xu, Xu, Xu, Xu, Ql, Ql, Ql, Ql, Ql^Xo, Ql^Xo, Ql^Xo, Ql^Xo, Ql^Xo, Ql^Xo, Ql^Xo, Ql, Ql, Xu, Xu, Xu, Xu, Xu, Xu, Xu, Xu, Xu, Xu, Xu, Xu, Xu, Xu, Xu
Wwg, Wwg^Ewl, Gll^Fp, Gll^Fp, Gll^Fp, Wwg, Wwg, Gll^Fdw, Rb^Es, Rb, Uu, Uu, Uu, Uu, Uu, Uu, Uu, Uu, Uu, Uu, Wwg, Wwg^Ewl, Uu, Xu, Xu, Xu, Xu, Xu, Xu, Xu, Xu, Xu, Wwrg, Xu, Wwrg, Xu, Xu, Xu, Xu, Xu, Xu, Xu, Xu, Xu, Xu, Xu, Xu, Xu, Ql, Ql, Ql^Xo, Ql^Xo, Ql, Ql, Ql, Ql, Ql, Ql, Ql, Ql^Xo, Ql^Xo, Ql, Ql, Xu, Xu, Xu, Xu, Xu, Xu, Xu, Xu, Xu, Xu, Xu, Xu, Xu
Xu, Xu, Xu, Xu, Xu, Gll^Fp, Wwg^Ewl, Wwg^Ewl, Wwg^Ewl, Rb^Es, Ur, Uu, Xu, Uu, Xu, Uu, Xu, Uu, Uu, Uu, Wwg, Wwg, Wwg^Ewl, Uu, Uu, Xu, Uu, Xu, Uu, Uu, Uu, Wwg, Wwrg, Wwrg, Xu, Xu, Xu, Xu, Xu, Xu, Xu, Xu, Xu, Xu, Xu, Xu, Xu, Xu, Ql, Ql^Xo, Ql, Ql, Ql, Ql, Ql, Ql, Ql, Ql, Ql, Ql, Ql, Ql^Xo, Ql^Xo, Ql, Ql, Ql, Xu, Xu, Xu, Xu, Xu, Xu, Xu, Xu, Xu, Xu
Xu, Xu, Xu, Xu, Xu, Xu, Uu, Wwg, Wwg, Uu, Ur, Xu, Xu, Xu, Xu, Xu, Xu, Xu, Wwg^Ewl, Wwg^Ewl, Wwg, Wwg, Uu, Uu, Uu, Uu, Uu, Uu, Uu, Uu, Wwg, Wwg, Wwrg, Wwrg, Xu, Xu, Xu, Xu, Xu, Xu, Xu, Xu, Xu, Xu, Xu, Xu, Xu, Xu, Ql, Ql^Xo, Ql, Ql, Ql, Ql, Ql, Ql, Uzw, Ql, Ql, Ql, Ql, Ql, Ql, Ql^Xo, Ql^Xo, Ql, Xu, Xu, Xu, Xu, Xu, Xu, Xu, Xu, Xu, Xu
Xu, Xu, Xu, Xu, Xu, Xu, Uu, Wwg, Wwg, Ur, Xu, Xu, Xu, Xu, Wwrg, Xu, Wwg, Uu, Wwg, Wwg, Wwg, Uu, Uu, Uu, Wwg, Wwg, Wwg, Wwg, Wwg, Wwg, Wwg^Ewl, Wwg, Wwg^Ewl, Wwg, Xu, Xu, Xu, Xu, Xu, Xu, Xu, Xu, Xu, Xu, Xu, Xu, Xu, Xu, Xu, Ql^Xo, Ql, Ql, Ql, Ql, Ql, Uzw^Vu, Uzw, Ql, Uzw, Uzw^Vu, Ql, Ql, Ql, Ql, Ql^Xo, Ql, Ql, Xu, Xu, Xu, Xu, Xu, Xu, Xu, Xu, Xu
Wwg, Xu, Xu, Xu, Xu, Xu, Uu, Wwg, Uu, Ur, Xu, Xu, Uu, Uu, Wwrg, Wwrg, Wwg, Wwg, Xu, Wwg, Wwg, Uu, Uu, Wwg, Wwrg, Wwrg, Wwg^Ewl, Wwg, Uu, Uu, Uu, Uu, Uu, Uu, Xu, Xu, Xu, Xu, Xu, Xu, Xu, Xu, Xu, Xu, Xu, Xu, Xu, Xu, Xu, Ql, Ql, Ql, Ql, Ql, Ql, Uzw, Ql, Uzw, 2 Ko, Uzw, Ql, Ql, Ql, Ql, Ql, Ql^Xo, Ql^Xo, Xu, Xu, Xu, Xu, Xu, Xu, Xu, Xu, Xu
Wwg, Wwg, Wwg, Xu, Xu, Xu, Uu, Wwg, Wwg^Ewl, Uu, Xu, Xu, Uu, Wwg^Ewl, Wwrg, Xu, Xu, Xu, Xu, Wwg, Wwg, Uu, Wwg, Wwg, Wwrg, Wwrg, Uu, Uu, Uu, Uu, Xu, Uu, Uu, Uu, Uu, Xu, Uu, Xu, Xu, Xu, Xu, Xu, Xu, Xu, Xu, Xu, Xu, Xu, Ql, Ql, Ql, Ql, Ql, Ql, Ql, Ql, Ql, Uzw, Uzw, Uzw, Uzw, Uzw, Ql, Ql, Ql, Ql, Ql^Xo, Xu, Xu, Xu, Xu, Xu, Xu, Xu, Xu, Xu
Xu, Xu, Xu, Wwrg, Wwrg, Uu, Wwrg, Wwg, Wwg, Uu, Uu, Uu, Wwg^Ewl, Wwg, Xu, Xu, Xu, Xu, Xu, Wwrg, Wwrg, Wwg, Wwg, Wwg, Wwg, Uu, Uu, Uu, Xu, Xu, Xu, Xu, Uu, Uu, Uu, Uu, Uu, Uu^Vud, Xu, Xu, Qlf, Xu, Qlf, Xu, Qlf, Xu, Ql, Ql, Ql, Ql, Ql, Ql, Ql, Ql, Ql, Ql, Ql, Uzw^Vu, Ql, Ql, Uzw, Uzw^Vu, Ql, Ql, Ql, Ql, Ql^Xo, Ql^Xo, Xu, Xu, Xu, Xu, Xu, Xu, Xu, Xu
Xu, Xu, Xu, Wwg, Wwrg, Wwrg, Xu, Wwg, Wwg, Wwg, Wwg^Ewl, Uu, Wwg, Wwg, Wwg, Uu, Uu, Xu, Uu, Wwrg, Xu, Xu, Xu, Wwg, Wwg, Uu, Xu, Xu, Xu, Xu, Xu, Xu, Xu, Uu, Xu, Uu, Uu, Uu, Uu, Qlf, Qlf, Qlf, Qlf, Qlf, Qlf, Qlf, Qlf, Ql, Ql, Ql, Ql, Ql, Qlf, Ql, Ql, Ql, Qlf, Ql, Ql, Ql, Ql, Ql, Ql, Ql, Ql, Ql, Ql^Xo, Ql, Xu, Xu, Xu, Xu, Xu, Xu, Xu, Xu
Xu, Xu, Uu^Vu, Uu, Uu, Uu, Xu, Xu, Xu, Wwrg, Wwrg, Wwrg, Wwg^Ewl, Wwg^Ewf, Wwg, Wwg, Wwg, Uu, Wwg, Wwg, Wwg, Xu, Xu, Xu, Wwg, Wwg^Ewl, Xu, Xu, Xu, Xu, Xu, Xu, Xu, Xu, Xu, Xu, Uu, Uu, Uu, Uu, Qlf, Qlf, Uu, Qlf, Uu, Qlf, Qlf, Qlf, Qlf, Qlf, Qlf, Qlf, Qlf, Qlf, Qlf, Qlf, Qlf, Qlf, Qlf, Ql, Ql, Ql, Ql, Ql, Ql^Xo, Ql^Xo, Ql, Ql, Xu, Xu, Xu, Xu, Xu, Xu, Xu, Xu
Xu, Xu, Xu, Uu, Uu, Uu, Uu, Uu^Vud, Xu, Wwg, Wwrg, Wwrg, Gll^Fp, Wwg^Ewl, Gll^Fdw, Wwg^Ewl, Wwg, Wwg, Wwg, Wwg, Xu, Wwg, Wwg, Xu, Wwg, Wwg, Uu, Xu, Xu, Xu, Xu, Xu, Xu, Xu, Xu, Xu, Xu, Uu, Uu, Uu, Uu, Qlf, Uu, Uu, Qlf, Qlf, Qlf, Qlf, Qlf, Qlf, Qlf, Uu, Qlf, Uu, Qlf, Qlf, Qlf, Qlf, Qlf, Ql, Ql, Ql, Ql, Ql, Ql^Xo, Ql, Ql, Ql, Xu, Xu, Xu, Xu, Xu, Xu, Xu, Xu
Wwg, Xu, Xu, Xu, Wwg, Wwg, Wwg, Wwg, Wwrg, Wwg^Ewl, Gll^Fdw, Gll^Fdw, Gll^Fp, Gll^Fmw, Gll^Fp, Gll^Fmw, Gll^Fmw, Wwg, Wwg, Wwg, Xu, Xu, Xu, Wwg, Wwg^Ewl, Uu, Xu, Xu, Xu, Xu, Xu, Xu, Xu, Xu, Xu, Xu, Xu, Uu, Uu, Uu, Uu, Uu, Uu, Uu, Uu, Qlf, Uu, Qlf, Uu, Qlf, Qlf, Uu, Uu, Uu, Qlf, Qlf, Qlf, Qlf, Qlf, Qlf, Qlf, Ql, Ql, Ql, Ql^Xo, Ql, Qlf, Ql, Xu, Xu, Xu, Xu, Xu, Xu, Xu, Xu
Wwg, Wwrg, Wwrg, Wwrg, Wwrg, Wwg, Wwg, Wwrg, Wwrg, Wwg^Ewl, Gll^Fmw, Gll^Fmw, Gs^Fms, Gs^Fms, Gll^Fp, Gs^Fms, Gll^Fp, Wwrg, Wwg, Wwg, Uu, Xu, Xu, Wwg, Uu, Xu, Xu, Xu, Xu, Xu, Xu, Xu, Xu, Xu, Xu, Xu, Xu, Xu, Uu, Uu, Uu, Xu, Xu, Uu, Uu, Uu, Uu, Qlf, Uu, Uu, Qlf, Uu, Qlf, Qlf, Qlf, Qlf, Qlf, Qlf, Qlf, Qlf, Qlf, Ql, Ql, Ql, Ql^Xo, Ql, Qlf, Qlf, Qlf, Xu, Xu, Xu, Xu, Xu, Xu, Xu
Wwg, Wwg, Uu, Uu, Uu, Uu, Wwg, Wwg^Ewl, Wwg^Ewl, Wwrg, Gll^Fmw, Gll^Fp, Gll^Fp, Gg^Fet, Gs^Fms, Gll^Fmw, Wwrg, Wwrg, Wwg, Wwg, Uu, Uu^Vud, Uu, Uu, Xu, Xu, Xu, Xu, Xu, Xu, Xu, Xu, Xu, Xu, Xu, Xu, Xu, Xu, Uu, Uu, Uu, Xu, Xu, Xu, Xu, Uu, Uu, Uu, Uu, Uu, Uu, Uu, Uu, Qlf, Uu, Uu, Uu, Qlf, Qlf, Qlf, Qlf, Qlf, Qlf^Xo, Ql^Xo, Qlf, Qlf, Qlf, Qlf, Qlf, Xu, Xu, Xu, Xu, Xu, Xu, Xu
Xu, Xu, Cud, Uu, Uu, Uu, Uu, Uu, Wwg, Wwrg, Wwg^Ewf, Gll^Fp, Gll^Fmw, Gs^Fms, Gll^Fp, Gll^Fmw, Wwg^Ewl, Wwrg, Wwg^Ewl, Xu, Xu, Uu, Uu, Uu, Xu, Xu, Xu, Xu, Xu, Xu, Xu, Xu, Xu, Xu, Xu, Xu, Xu, Xu, Xu, Uu, Uu, Uu, Uu, Xu, Xu, Uu, Qlf, Uu, Uu, Uu, Uu, Uu, Uu, Uu, Uu, Uu, Uu, Qlf, Qlf, Qlf, Qlf, Qlf, Qlf^Xo, Qlf, Qlf, Qlf, Qlf, Qlf, Qlf, Qlf, Xu, Xu, Xu, Xu, Xu, Xu
Xu, Xu, Kud, Cud, Uu, Uu, Uu^Vud, Uu, Wwrg, Wwg^Ewf, Wwg^Ewf, Gll^Fdw, Gll^Fmw, Gll^Fdw, Wwrg, Gll^Fp, Wwg^Ewl, Wwg, Xu, Xu, Xu, Xu, Uu, Uu, Xu, Xu, Xu, Xu, Xu, Xu, Xu, Xu, Xu, Xu, Xu, Xu, Xu, Xu, Qlf, Uu, Uu, Uu, Uu, Xu, Uu, Uu, Qlf, Qlf, Xu, Uu, Uu, Uu, Uu, Uu, Qlf, Qlf, Xu, Qlf, Qlf, Qlf, Qlf^Xo, Qlf^Xo, Qlf, Qlf, Qlf, Qlf, Qlf, Qlf, Qlf, Qlf, Xu, Xu, Xu, Xu, Xu, Xu
Xu, Xu, Xu, Cud, Uu, Uu, Uu, Uu, Wwrg, Wwg, Wwg^Ewf, Wwg^Ewf, Wwg, Gll^Fdw, Wwrg, Wwrg, Wwg, Wwg^Ewl, Xu, Xu, Xu, Xu, Uu, Uu, Uu, Xu, Xu, Xu, Xu, Xu, Xu, Xu, Xu, Xu, Xu, Xu, Xu, Xu, Qlf, Qlf, Qlf, Uu, Uu, Uu, Uu, Qlf, Xu, Xu, Xu, Xu, Uu, Uu, Uu, Qlf, Xu, Xu, Xu, Xu, Xu, Qlf^Xo, Qlf, Qlf, Qlf, Qlf, Qlf, Qlf, Qlf, Qlf, Xu, Xu, Xu, Xu, Xu, Xu, Xu, Xu
Wwg, Wwg^Ewl, Wwg^Ewl, Uu, Wwg^Ewl, Uu, Wwg^Ewl, Wwrg, Wwrg, Wwrg, Wwg, Wwg, Wwg, Wwrg, Wwrg, Wwg, Wwg^Ewl, Xu, Xu, Xu, Xu, Xu, Xu, Uu, Uu, Xu, Xu, Xu, Xu, Xu, Xu, Xu, Xu, Xu, Xu, Xu, Xu, Xu, Qlf, Qlf, Uu, Uu, Uu, Uu, Uu, Qlf, Qlf, Xu, Xu, Xu, Uu, Uu, Qlf, Qlf, Xu, Xu, Xu, Xu, Xu, Xu, Xu, Qlf, Qlf, Qlf, Xu, Qlf, Qlf, Xu, Xu, Xu, Xu, Xu, Xu, Xu, Xu, Xu
Wwg, Wwg, Wwg, Wwg, Wwg, Wwg^Ewl, Wwrg, Wwrg, Wwg, Wwg, Wwg^Ewl, Wwg^Ewl, Wwg, Wwg, Wwg, Wwg, Xu, Xu, Xu, Xu, Xu, Xu, Xu, Uu, Uu, Uu, Uu, Uu, Uu, Uu, Uu, Xu, Xu, Xu, Xu, Xu, Qlf, Qlf, Qlf, Qlf, Uu, Qlf, Qlf, Uu, Uu, Uu, Uu, Qlf, Uu, Uu, Uu, Uu, Qlf, Qlf, Xu, Xu, Xu, Xu, Xu, Xu, Xu, Xu, Xu, Xu, Xu, Xu, Xu, Xu, Xu, Xu, Xu, Xu, Xu, Xu, Xu, Xu
Xu, Xu, Xu, Wwg^Ewl, Wwg^Ewl, Wwg, Wwg, Wwg, Uu, Uu, Uu, Uu, Uu, Wwg^Ewl, Uu, Xu, Xu, Xu, Xu, Xu, Xu, Xu, Uu, Uu, Uu, Xu, Xu, Uu, Xu, Uu, Uu, Xu, Xu, Xu, Xu, Xu, Uu, Uu, Uu, Uu, Uu, Qlf, Qlf, Uu, Qlf, Qlf, Uu, Uu, Uu, Uu, Uu, Qlf, Qlf, Qlf, Xu, Xu, Xu, Xu, Xu, Xu, Xu, Xu, Xu, Xu, Xu, Xu, Xu, Xu, Xu, Xu, Xu, Xu, Xu, Xu, Xu, Xu
Xu, Xu, Xu, Xu, Xu, Xu, Xu, Wwg, Xu, Uu, Uu, Uu, Uu, Uu, Uu, Uu, Xu, Xu, Xu, Xu, Uu, Uu, Uu, Uu, Xu, Xu, Uu, Xu, Xu, Uu, Uu, Uu, Xu, Xu, Qlf, Uu, Uu, Uu, Qlf, Uu, Uu, Uu, Qlf, Qlf, Qlf, Qlf, Uu, Uu, Uu, Uu, Uu, Xu, Xu, Xu, Xu, Xu, Xu, Xu, Xu, Xu, Xu, Xu, Xu, Xu, Xu, Xu, Xu, Xu, Xu, Xu, Xu, Xu, Xu, Xu, Xu, Xu
Xu, Xu, Xu, Xu, Xu, Xu, Xu, Xu, Xu, Xu, Xu, Xu, Xu, Uu, Uu, Uu, Uu, Xu, Uu, Uu, Uu, Uu, Uu, Uu, Uu, Uu, Uu, Uu, Uu, Uu, Uu, Uu, Uu, Qlf, Uu, Uu, Uu, Qlf, Qlf, Qlf, Uu, Uu, Xu, Xu, Xu, Xu, Uu, Uu, Uu, Uu, Uu, Uu, Xu, Xu, Xu, Xu, Xu, Xu, Xu, Xu, Xu, Xu, Xu, Xu, Xu, Xu, Xu, Xu, Xu, Xu, Xu, Xu, Xu, Xu, Xu, Xu
Xu, Xu, Xu, Xu, Xu, Xu, Xu, Xu, Xu, Xu, Xu, Xu, Xu, Xu, Qxu, Uu, Uu, Uu, Uu, Uu, Qxu, Qxu, Qxu, Xu, Xu, Uu, Xu, Xu, Xu, Uu, Xu, Uu, Uu, Uu, Uu, Uu, Uu, Uu, Uu, Qlf, Xu, Xu, Xu, Xu, Xu, Xu, Xu, Uu, Xu, Uu, Uu, Uu, Uu, Xu, Xu, Xu, Xu, Xu, Xu, Xu, Xu, Xu, Xu, Xu, Xu, Xu, Xu, Xu, Xu, Xu, Xu, Xu, Xu, Xu, Xu, Xu
Xu, Xu, Xu, Xu, Xu, Xu, Xu, Xu, Qxu, Qxu, Qxu, Xu, Xu, Xu, Qxu, Qxu, Qxu, Uu, Uu, Uu, Uu, Qxu, Qxu, Xu, Xu, Xu, Xu, Xu, Xu, Xu, Xu, Xu, Xu, Xu, Xu, Xu, Xu, Uu, Xu, Xu, Xu, Xu, Xu, Xu, Xu, Xu, Xu, Xu, Xu, Xu, Xu, Uu, Uu, Xu, Xu, Xu, Xu, Xu, Xu, Xu, Xu, Xu, Xu, Xu, Xu, Xu, Xu, Xu, Xu, Xu, Xu, Xu, Xu, Xu, Xu, Xu
Xu, Xu, Xu, Xu, Xu, Xu, Qxu, Qxu^Xo, Qxu, Qxu, Qxu, Qxu, Qxu, Qxu, Qxu, Qxu, Qxu, Qxu, Uu, Uu, Uu, Qxu, Qxu, Qxu, Xu, Xu, Xu, Xu, Xu, Xu, Xu, Xu, Xu, Xu, Xu, Xu, Xu, Xu, Xu, Xu, Xu, Xu, Xu, Xu, Xu, Xu, Xu, Xu, Xu, Xu, Xu, Uu, Uu^Ii, Xu, Xu, Xu, Xu, Xu, Xu, Xu, Xu, Xu, Xu, Xu, Xu, Xu, Xu, Xu, Xu, Xu, Xu, Xu, Xu, Xu, Xu, Xu
Xu, Xu, Xu, Xu, Qxu, Qxu, Qxu, Qxu^Xo, Qxu, Qxu, Qxu, Qxu, Qxu, Qxu, Qxu, Qxu, Qxu, Qxu, Uu, Uu, Uu, Qxu, Qxu, Qxu, Xu, Xu, Xu, Xu, Xu, Xu, Xu, Xu, Xu, Xu, Xu, Xu, Xu, Xu, Xu, Xu, Xu, Xu, Xu, Xu, Xu, Xu, Xu, Xu, Xu, Xu, Xue, Uu^Ii, Xu, Xue, Xue, Xu, Xue, Xu, Xu, Xu, Xu, Xu, Xu, Xu, Xu, Xu, Xu, Xu, Xu, Xu, Xu, Xu, Xu, Xu, Xu, Xu
Xu, Xu, Qxu, Qxu, Qxu^Xo, Qxu, Qxu^Xo, Qxu^Xo, Qxu, Qxu, Qxu, Qxu, Qxu, Qxu, Qxu, Qxu, Qxu, Qxu, Qxu, Uu, Uu, Uu, Uu, Qxu, Qxu, Xu, Qxu, Qxu, Qxu, Xu, Xu, Xu, Xu, Xu, Xu, Xu, Xu, Xu, Xu, Xu, Xu, Xu, Xu, Xu, Xu, Xu, Xu, Xu, Xu, Xue, Xue, Xue, Uue, Uue, Uue, Xue, Uue, Xue, Xue, Xu, Xu, Xu, Xu, Xu, Xu, Xu, Xu, Xu, Xu, Xu, Xu, Xu, Xu, Xu, Xu, Xu
Qxu, Qxu, Qxu, Qxu^Xo, Qxu^Xo, Qxu^Xo, Qxu, Qxu, Qxu, Qxu, Qxu, Qxu, Qxu, Qxu, Qxu, Qxu, Qxu, Qxu, Qxu, Uu, Uu, Uu, Uu, Qxu, Qxu, Qxu, Qxu, Qxu, Qxu, Qxu, Xu, Xu, Xu, Xu, Xu, Xu, Xu, Xu, Xu, Xu, Xu, Xu, Xu, Xu, Xu, Xu, Xu, Xu, Xu, Xu, Xu, Xue, Uue, Uue, Uue, Uue, Uue, Uue, Uue, Xue, Xue, Xu, Xu, Xu, Xu, Xu, Xu, Xu, Xu, Xu, Xu, Xu, Xu, Xu, Xu, Xu
Qxu, Qxu, Qxu^Xo, Qxu^Xo, Qxu, Qxu, Qxu, Qxu, Qxu, Qxu, Qxu, Qxu, Qxu, Qxu, Qxu, Qxu, Qxu, Qxu, Qxu, Qxu, Qxu, Uu, Uu, Uu, Qxu, Qxu, Qxu, Qxu, Qxu, Qxu, Qxu, Xu, Xu, Xu, Xu, Xu, Xu, Xu, Xu, Xu, Xu, Xu, Xu, Xu, Xu, Xu, Xu, Xu, Xu, Xu, Xu, Xue, Xue, Xue, Xue, Uue, Uue, Uue, Uue, Xue, Xue, Xu, Xu, Xu, Xu, Xu, Xu, Xu, Xu, Xu, Xu, Xu, Xu, Xu, Xu, Xu
Qxu^Xo, Qxu^Xo, Qxu, Qxu, Qxu, Qxu, Qxu, Qxu, Qxu, Qxu, Qxu, Qxu, Qxu, Qxu, Qxu, Qxu, Qxu, Qxu, Qxu, Qxu, Qxu, Uu, Uu, Qxu, Qxu, Qxu, Qxu, Qxu, Qxu, Qxu, Qxu, Qxu, Qxu, Xu, Xu, Xu, Xu, Xu, Xu, Xu, Xu, Xu, Xu, Xu, Xu, Xu, Xu, Xu, Xu, Xu, Xu, Xu, Xue, Xue, Uue, Uue, Xue, Uue, Uue, Uue, Uue, Xue, Xue, Xu, Xu, Xu, Xue, Xu, Xu, Xu, Xu, Xu, Xu, Xu, Xu, Xu
Qxu, Qxu, Qxu, Qxu, Qxu, Qxu, Qxu, Qxu, Qxu, Qxu, Qxu, Qxu, Qxu, Qxu, Qxu, Qxu, Qxu, Qxu, Qxu, Qxu, Uu, Uu, Uu, Qxu, Qxu, Qxu, Qxu, Qxu, Qxu, Qxu, Qxu, Qxu, Qxu, Qxu, Qxu, Xu, Xu, Xu, Xu, Xu, Xue, Xue, Xue, Xu, Xue, Xu, Xu, Xu, Xu, Xu, Xu, Xue, Uue, Uue, Xue, Xue, Xue, Xue, Xue, Uue, Xue, Xue, Xue, Xue, Xue, Xue, Xue, Xue, Xue, Xu, Xue, Xu, Xu, Xu, Xu, Xu
Qxu, Qxu, Qxu, Qxu, Qxu, Qxu, Qxu, Qxu, Qxu, Qxu, Qxu, Qxu, Qxu, Qxu, Qxu, Qxu, Qxu, Qxu, Qxu, Qxu, Uu, Uu, Uu, Qxu, Qxu, Qxu, Qxu, Qxu, Qxu, Qxu, Qxu, Qxu, Qxu, Qxu, Qxu^Xo, Qxu^Xo, Qxu, Qxu, Qxu, Xu, Xue, Xue, Xue, Xue, Xue, Xu, Xu, Xu, Xu, Xu, Xu, Xue, Xue, Xue, Xu, Xu, Xue, Xue, Uue, Xue, Uue, Xue, Xue, Xue, Xue, Xue, Xue, Xue, Xue, Xue, Xue, Xue, Xue, Xu, Xu, Xu
Qxu, Qxu, Qxu, Qxu, Qxu, Qxu, Qxu, Qxu, Qxu, Qxu, Qxu, Qxu, Urb, Qxu, Qxu, Qxu, Qxu, Qxu, Qxu, Uu, Uu, Uu, Qxu, Qxu, Qxu, Qxu, Qxu, Qxu, Qxu, Qxu, Qxu, Qxu, Qxu^Xo, Qxu^Xo, Qxu, Qxu, Qxu, Qxu, Qxu, Xu, Xue, Xue, Xue, Xue, Xue, Xu, Xu, Xu, Xue, Xu, Xu, Xu, Xu, Xu, Xue, Xue, Uue, Uue, Uue, Uue, Uue, Uue, Uue, Xue, Xue, Xue, Xue, Xue, Xue, Xue, Xue, Xue, Xue, Xue, Xue, Xue
Qxu, Qxu, Qxu, Qxu, Qxu, Qxu, Qxu, Qxu, Qxu, Qxu, Urb, Urb, Urb, Urb, Urb, Uu, Uu, Uu, Uu, Uu, Uu, Uu, Qxu, Qxu, Qxu, Qxu, Qxu, Qxu, Qxu, Qxu, Qxu, Qxu^Xo, Qxu, Qxu, Qxu, Qxu, Qxu, Qxu, Qxu, Xu, Xue, Xue, Xue, Xue, Xue, Xue, Xue, Xu, Xue, Xue, Xu, Xu, Xue, Xue, Uue, Uue, Uue, Uue, Uue, Ql, Uue, Uue, Uue, Uue, Uue, Xue, Xue, Xue, Xue, Xue, Xue, Xue, Xue, Xue, Xue, Xue
Qxu, Qxu, Qxu, Qxu, Qxu, Qxu, Qxu, Qxu, Urb, Urb, Urb, Urb, Qxu, Urb, Urb, Urb, Urb, Uu, Uu, Uu, Qxu, Qxu, Qxu, Qxu, Qxu, Qxu, Qxu, Qxu, Qxu, Qxu, Qxu^Xo, Qxu^Xo, Qxu, Qxu, Qxu, Qxu, Qxu, Qxu, Qxu, Xu, Xu, Xue, Xue, Xue, Xue, Xue, Xu, Xu, Xu, Xu, Xue, Xue, Uue, Uue, Uue, Uue, Uue, Uue, Uue, Qlf, Uue, Uue, Uue, Uue, Uue, Uue, Uue, Xue, Xue, Xue, Xue, Xue, Xue, Xue, Xue, Xue
Qxu, Qxu, Qxu, Qxu, Qxu, Qxu, Urb, Urb, Urb, Urb, Qxu, Qxu, Qxu, Qxu, Qxu, Urb, Urb, Urb, Urb, Uu, Qxu, Qxu, Qxu, Qxu, Qxu, Qxu, Qxu, Qxu, Qxu, Qxu, Qxu^Xo, Qxu, Qxu, Qxu, Qxu, Qxu, Qxu, Qxu, Qxu, Qxu, Xu, Xue, Xu, Xu, Xue, Xu, Xu, Xu, Xue, Xue, Uue, Uue, Uue, Uue, Ql, Uue, Uue, Uue, Uue, Qlf, Uue, Uue, Uue, Uue, Ql, Uue, Uue, Uue, Uue, Xue, Xue, Xue, Xue, Xue, Xue, Xue
Qxu, Qxu, Qxu, Qxu, Qxu, Qxu, Urb, Urb, Urb, Qxu, Qxu, Qxu, Mv^Ii, Qxu, Qxu, Qxu, Urb, Urb, Urb, Qxu, Qxu, Qxu, Qxu, Qxu, Qxu, Qxu, Qxu, Qxu, Qxu, Qxu, Qxu^Xo, Qxu, Qxu, Qxu, Qxu, Qxu, Qxu, Qxu, Qxu, Qxu, Qxu, Xu, Xu, Xu, Xu, Xu, Xue, Xue, Uue, Uue, Uue, Uue, Uue, Uue, Qlf, Qlf, Qlf, Uue, Qxe, Qxe, Qxe, Uue, Qlf, Qlf, Qlf, Uue, Uue, Uue, Uue, Uue, Uue, Xue, Xue, Xue, Xue, Xue
Qxu, Qxu, Qxu, Qxu, Qxu, Qxu, Urb, Urb, Urb, Qxu, Qxu, Mm^Ii, Mm^Ii, Mm^Ii, Qxu, Qxu, Urb, Urb, Urb, Qxu, Qxu, Qxu, Qxu, Qxu, Qxu, Qxu, Qxu, Qxu, Qxu, Qxu, Qxu^Xo, Qxu, Qxu, Qxu, Qxu, Qxu, Qxu, Qxu, Qxu, Qxu, Qxu, Qxu, Xu, Xu, Xu, Xu, Xue, Uue, Uue, Uue, Uue, Uue, Uue, Uue, Qlf, Uue^Fp, Uue^Fp, Qxe, Qxe, Qxe, Qxe, Qxe, Uue^Fp, Uue^Fp, Qlf, Uue, Uue, Uue, Uue, Uue, Uue, Uue, Xue, Xue, Xue, Xue
Qxu, Qxu, Qxu, Qxu, Qxu, Qxu, Urb, Urb, Urb, Qxu, Qxu, Qxu, Qxu, Qxu, Qxu, Qxu, Urb, Urb, Urb, Qxu, Qxu, Qxu, Qxu, Qxu, Qxu, Qxu, Qxu, Qxu, Qxu, Qxu, Qxu^Xo, Qxu, Qxu, Qxu, Qxu, Qxu, Qxu, Qxu, Qxu, Qxu, Qxu, Qxu, Xu, Xu, Xu, Xu, Xue, Uue, Uue, Ql, Qlf, Uue, Uue, Uue, Qxe, Uue^Fp, Uue^Fp, Qxe, Qxe, Qxe, Qxe, Qxe, Uue^Fp, Uue^Fp, Qxe, Uue, Uue, Uue, Qlf, Ql, Uue, Uue, Xue, Xue, Xu, Xue
Qxu, Qxu, Qxu, Qxu, Qxu, Qxu, Urb, Urb, Urb, Urb, Urb, Qxu, Qxu, Qxu, Urb, Urb, Urb, Urb, Urb, Qxu, Qxu, Qxu, Qxu, Qxu, Qxu, Qxu, Qxu, Qxu, Qxu, Qxu, Qxu^Xo, Qxu, Qxu, Qxu, Qxu, Qxu, Qxu, Qxu, Qxu, Qxu, Qxu, Qxu, Xu, Xu, Xu, Xu, Xue, Uue, Uue, Uue, Uue, Qlf, Qxe, Qxe, Qxe, Qxu^Ii, Qxu^Ii, Qxe, Uue^Fet, Uue^Fet, Uue^Fet, Qxe, Qxe^Ii, Qxe^Ii, Qxe, Qxe, Qxe, Qlf, Uue, Uue, Uue, Uue, Xue, Xue, Xu, Xue
Qxu, Qxu, Qxu, Qxu, Qxu, Qxu, Qxu, Urb, Urb, Urb, Urb, Urb, Urb, Urb, Urb, Urb, Urb, Urb, Qxu, Qxu, Qxu, Qxu, Qxu, Qxu, Qxu, Qxu, Qxu, Qxu, Qxu, Qxu, Qxu^Xo, Qxu, Qxu, Qxu, Qxu, Qxu, Qxu, Qxu, Qxu, Qxu, Qxu, Xu, Xu, Xu, Xu, Xu, Xue, Uue, Uue, Uue, Uue, Uue, Qxu, Qxe, Qxu, Qxe, Qxe, Qxu^Ii, Qxe, Uue^Fet, Qxe, Qxe^Ii, Qxe, Qxe, Qxe, Qxe, Qxe, Uue, Uue, Uue, Uue, Uue, Xue, Xue, Xu, Xu
Qxu, Qxu, Qxu, Qxu, Qxu, Qxu, Qxu, Qxu, Qxu, Urb, Urb, Urb, Urb, Urb, Urb, Urb, Qxu, Qxu, Qxu, Qxu, Qxu, Qxu, Qxu, Qxu, Qxu, Qxu, Qxu, Qxu, Qxu, Qxu, Qxu^Xo, Qxu, Qxu, Qxu, Qxu, Qxu, Qxu, Qxu, Qxu, Qxu, Qxu, Xu, Xu, Xu, Xu, Xu, Xue, Uue, Uue, Uue, Qlf, Qlf, Uue^Fp, Qxe, Qxe, Qxe, Uue^Fet, Qxu^Ii, Qxu^Ii, Qxe, Qxe^Ii, Qxu^Ii, Uue^Fet, Qxe, Qxe, Qxe, Uue^Fp, Qlf, Qlf, Uue, Uue, Uue, Xue, Xue, Xue, Xu
Qxu, Qxu, Qxu, Qxu, Qxu, Qxu, Qxu, Qxu, Qxu, Qxu, Qxu, Urb, Urb, Urb, Qxu, Qxu, Qxu, Qxu, Qxu, Qxu, Qxu, Qxu, Qxu, Qxu, Qxu, Qxu, Qxu, Qxu, Qxu, Qxu, Qxu^Xo, Qxu, Qxu, Qxu, Qxu, Qxu, Qxu, Qxu, Qxu, Qxu, Qxu, Xu, Xu, Xu, Xu, Xu, Xue, Uue, Uue, Ql, Qlf, Uue^Fp, Uue^Fp, Uue^Fp, Qxe, Uue^Fet, Uue^Fet, Qxe, Qxe, Uue^Ii, Qxe, Qxe, Uue^Fet, Uue^Fet, Qxe, Uue^Fp, Uue^Fp, Uue^Fp, Qlf, Ql, Uue, Uue, Xue, Xue, Xue, Xu
Qxu, Qxu, Qxu, Qxu, Qxu, Qxu, Qxu, Qxu, Qxu, Qxu, Qxu, Qxu, Qxu, Qxu, Qxu, Qxu, Qxu, Qxu, Qxu, Qxu, Qxu, Qxu, Qxu, Qxu, Qxu, Qxu, Qxu, Qxu, Qxu^Xo, Qxu^Xo, Qxu, Qxu, Qxu, Qxu, Qxu, Qxu, Qxu, Qxu, Qxu, Qxu, Xu, Xu, Xu, Xu, Xu, Xu, Xue, Uue, Uue, Uue, Uue, Qlf, Qxu, Qxe, Qxe, Qxe, Qxu^Ii, Qxu^Ii, Qxe, Qxe, Qxe, Qxu^Ii, Qxu^Ii, Qxe, Qxe, Qxe, Qxe, Qlf, Uue, Uue, Uue, Uue, Xue, Xue, Xue, Xu
Qxu, Qxu, Qxu, Qxu, Qxu, Qxu, Qxu, Qxu, Qxu, Qxu, Qxu, Qxu, Qxu, Qxu, Qxu, Qxu, Qxu, Qxu, Qxu, Qxu, Qxu, Qxu, Qxu, Qxu, Qxu, Qxu, Qxu, Qxu, Qxu^Xo, Qxu, Qxu, Qxu, Qxu, Qxu, Qxu, Qxu, Qxu, Qxu, Qxu, Qxu, Xu, Xu, Xu, Xu, Xu, Xu, Xue, Uue, Uue, Uue, Uue, Uue, Qxe, Qxe, Qxe, Qxe, Qxe, Qxe, Uue^Fet, Uue^Fet, Uue^Fet, Qxe, Qxe, Qxe, Qxe, Qxe, Qxe, Uue, Uue, Uue, Uue, Uue, Xue, Xue, Xue, Xu
Qxu^Xo, Qxu, Qxu, Qxu, Qxu, Qxu, Qxu, Qxu, Qxu, Qxu, Qxu, Qxu, Qxu, Qxu, Qxu, Qxu, Qxu, Qxu, Qxu, Qxu, Qxu, Qxu, Qxu, Qxu, Qxu, Qxu, Qxu^Xo, Qxu^Xo, Qxu, Qxu, Qxu, Qxu, Qxu, Qxu, Qxu, Qxu, Qxu, Qxu, Qxu, Qxu, Xu, Xu, Xu, Xu, Xu, Xu, Xue, Uue, Uue, Uue, Qlf, Qlf, Uue, Qxe, Qxe, Qxe, Uue^Fp, Qxu, Qxu, Uue^Fet, Qxu, Qxu, Uue^Fp, Qxe, Qxe, Qxe, Uue, Qlf, Qlf, Uue, Uue, Uue, Xue, Xue, Xue, Xu
Qxu, Qxu^Xo, Qxu^Xo, Qxu, Qxu, Qxu, Qxu, Qxu, Qxu, Qxu, Qxu, Qxu, Qxu, Qxu, Qxu, Qxu, Qxu, Qxu, Qxu, Qxu, Qxu, Qxu, Qxu, Qxu, Qxu^Xo, Qxu^Xo, Qxu, Qxu, Qxu, Qxu, Qxu, Qxu, Qxu, Qxu, Qxu, Qxu, Qxu, Qxu, Qxu, Qxu, Xu, Xu, Xu, Xu, Xu, Xu, Xue, Uue, Uue, Ql, Uue, Uue, Uue, Uue, Qlf, Uue^Fp, Uue^Fp, Qxe, Qxe, Qxu, Qxe, Qxe, Uue^Fp, Uue^Fp, Qlf, Uue, Uue, Uue, Uue, Ql, Uue, Uue, Xue, Xue, Xue, Xu
Qxu, Qxu, Qxu, Qxu^Xo, Qxu^Xo, Qxu, Qxu, Qxu, Qxu, Qxu, Qxu, Qxu, Qxu, Qxu, Qxu, Qxu, Qxu, Qxu, Qxu, Qxu, Qxu, Qxu, Qxu^Xo, Qxu^Xo, Qxu, Qxu, Qxu, Qxu, Qxu, Qxu, Qxu, Qxu, Qxu, Qxu, Qxu, Qxu, Qxu, Qxu, Qxu, Qxu, Xu, Xu, Xu, Xu, Xu, Xu, Xue, Xue, Xue, Uue, Uue, Uue, Uue, Uue, Qlf, Uue^Fp, Qlf, Qxe, Qxe, Qxe, Qxe, Qxe, Qlf, Uue^Fp, Qlf, Uue, Uue, Uue, Uue, Uue, Xue, Xue, Xue, Xue, Xu, Xu
Qxu, Qxu, Qxu, Qxu, Qxu, Qxu^Xo, Qxu^Xo, Qxu, Qxu, Qxu, Qxu, Qxu, Qxu, Qxu, Qxu, Qxu, Qxu, Qxu, Qxu, Qxu, Qxu^Xo, Qxu^Xo, Qxu, Qxu, Qxu, Qxu, Qxu, Qxu, Qxu, Qxu, Qxu, Qxu, Qxu, Qxu, Qxu, Qxu, Qxu, Qxu, Qxu, Qxu, Xu, Xu, Xu, Xu, Xu, Xu, Xue, Xue, Xue, Xue, Xue, Uue, Uue, Uue, Ql, Qlf, Uue, Uue, Uue, Qxe, Uue, Uue, Uue, Qlf, Ql, Uue, Uue, Uue, Xue, Xue, Xue, Xue, Xue, Xue, Xu, Xu
Qxu, Qxu, Qxu, Qxu, Qxu, Qxu, Qxu, Qxu^Xo, Qxu^Xo, Qxu, Qxu, Qxu, Qxu, Qxu, Qxu, Qxu, Qxu, Qxu, Qxu^Xo, Qxu^Xo, Qxu, Qxu, Qxu, Qxu, Qxu, Qxu, Qxu, Qxu, Qxu, Qxu, Qxu, Qxu, Qxu, Qxu, Qxu, Qxu, Qxu, Qxu, Qxu, Qxu, Xu, Xu, Xu, Xu, Xu, Xu, Xue, Xue, Xue, Xue, Xue, Xue, Xue, Uue, Uue, Uue, Uue, Uue, Uue, Qlf, Uue, Uue, Uue, Uue, Uue, Uue, Xue, Xue, Xue, Xue, Xue, Xue, Xue, Xue, Xu, Xu
Qxu, Qxu, Qxu, Qxu, Qxu, Qxu, Qxu, Qxu, Qxu, Qxu^Xo, Qxu^Xo, Qxu, Qxu, Qxu, Qxu, Qxu, Qxu^Xo, Qxu^Xo, Qxu, Qxu, Qxu, Qxu, Qxu, Qxu, Qxu, Qxu, Qxu, Qxu, Qxu, Qxu, Qxu, Qxu, Qxu, Qxu, Qxu, Qxu, Qxu, Qxu, Qxu, Qxu, Xu, Xu, Xu, Xu, Xu, Xu, Xu, Xue, Xue, Xue, Xue, Xue, Xue, Xue, Xue, Uue, Uue, Uue, Uue, Qlf, Uue, Uue, Uue, Uue, Xue, Xue, Xue, Xue, Xue, Xue, Xue, Xue, Xue, Xue, Xu, Xu
Qxu, Qxu, Qxu, Qxu, Qxu, Qxu, Qxu, Qxu, Qxu, Qxu^Xo, Qxu^Xo, Qxu, Qxu, Qxu, Qxu^Xo, Qxu^Xo, Qxu, Qxu, Qxu, Qxu, Qxu, Qxu, Qxu, Qxu, Qxu, Qxu, Qxu, Qxu, Qxu, Qxu, Qxu, Qxu, Qxu, Qxu, Qxu, Qxu, Qxu, Qxu, Qxu, Qxu, Xu, Xu, Xu, Xu, Xu, Xu, Xu, Xu, Xu, Xue, Xue, Xue, Xue, Xue, Xue, Xue, Xue, Uue, Uue, Ql, Uue, Uue, Xue, Xue, Xue, Xue, Xue, Xue, Xue, Xue, Xue, Xue, Xu, Xu, Xu, Xu
Qxu, Qxu, Qxu, Qxu, Qxu, Qxu, Qxu, Qxu, Qxu, Qxu, Qxu, Qxu^Xo, Qxu^Xo, Qxu^Xo, Qxu, Qxu, Qxu, Qxu, Qxu, Qxu, Qxu, Qxu, Qxu, Qxu, Qxu, Qxu, Qxu, Qxu, Qxu, Qxu, Qxu, Qxu, Qxu, Qxu, Qxu, Qxu, Qxu, Qxu, Qxu, Qxu, Xu, Xu, Xu, Xu, Xu, Xu, Xu, Xu, Xu, Xue, Xue, Xue, Xue, Xue, Xue, Xue, Xue, Xue, Xue, Uue, Xue, Xue, Xue, Xue, Xue, Xue, Xue, Xue, Xue, Xue, Xu, Xu, Xu, Xu, Xu, Xu
Qxu, Qxu, Qxu, Qxu, Qxu, Qxu, Qxu, Qxu, Qxu, Qxu, Qxu, Qxu, Qxu, Qxu, Qxu, Qxu, Qxu, Qxu, Qxu, Qxu, Qxu, Qxu, Qxu, Qxu, Qxu, Qxu, Qxu, Qxu, Qxu, Qxu, Qxu, Qxu, Qxu, Qxu, Qxu, Qxu, Qxu, Qxu, Qxu, Qxu, Xu, Xu, Xu, Xu, Xu, Xu, Xu, Xu, Xu, Xu, Xu, Xue, Xue, Xue, Xue, Xue, Xue, Xue, Xue, Xue, Xue, Xue, Xue, Xue, Xue, Xue, Xue, Xue, Xu, Xu, Xu, Xu, Xu, Xu, Xu, Xu
Qxu, Qxu, Qxu, Qxu, Qxu, Qxu, Qxu, Qxu, Qxu, Qxu, Qxu, Qxu, Qxu, Qxu, Qxu, Qxu, Qxu, Qxu, Qxu, Qxu, Qxu, Qxu, Qxu, Qxu, Qxu, Qxu, Qxu, Qxu, Qxu, Qxu, Qxu, Qxu, Qxu, Qxu, Qxu, Qxu, Qxu, Qxu, Qxu, Qxu, Xu, Xu, Xu, Xu, Xu, Xu, Xu, Xu, Xu, Xu, Xu, Xu, Xue, Xue, Xue, Xue, Xue, Xue, Xue, Xue, Xue, Xue, Xue, Xue, Xue, Xue, Xu, Xu, Xu, Xu, Xu, Xu, Xu, Xu, Xu, Xu
Qxu, Qxu, Qxu, Qxu, Qxu, Qxu, Qxu, Qxu, Qxu, Qxu, Qxu, Qxu, Qxu, Qxu, Qxu, Qxu, Qxu, Qxu, Qxu, Qxu, Qxu, Qxu, Qxu, Qxu, Qxu, Qxu, Qxu, Qxu, Qxu, Qxu, Qxu, Qxu, Qxu, Qxu, Qxu, Qxu, Qxu, Qxu, Qxu, Qxu, Xu, Xu, Xu, Xu, Xu, Xu, Xu, Xu, Xu, Xu, Xu, Xu, Xu, Xue, Xu, Xue, Xue, Xue, Xue, Xue, Xue, Xue, Xue, Xue, Xu, Xu, Xu, Xu, Xu, Xu, Xu, Xu, Xu, Xu, Xue, Xue
