border_size=1
usage=map

Brym, Brym, Gg, Brym, Brym, Brym, Btym, Brym, Btym, Btyb, Btyb, Brym, Brym, Brym, Brym, Brym, Brym, Brym, Brym, Brym, Brym, Brym, Brym, Brym, Brym, Brym, Brym, Brym, Btyb, Brym, Btym, Brym, Btym, Btym, Btym, Btym, Btym, Btym, Xos, Btym, Btym, Btym
Brym, Gg, Gg^Fet, Gg, Brym, Btym, Btym, Btym, Btym, Btym, Btym, Btyb, Btyb, Brym, Brym, Brym, Brym, Brym, Brym, Brym, Brym, Brym, Brym, Brym, Brym, Brym, Btyb, Btyb, Btym, Btym, Btym, Btym, Btym, Btym, Btym, Btym, Btym, Xol, Xol, Xol, Btym, Btym
Brym, Gg, Gg, Gg, Brym, Brym, Btym, Btym, Btym, Btym, Btym, Btym, Btym, Btyb, Btyb, Brym, Btyb, Brym, Brym, Brym, Brym, Brym, Brym, Brym, Btyb, Btyb, Btym, Btym, Btym, Btym, Btym, Btym, Btym, Btym, Btym, Btym, Brym, Cpy, Cpy, Cpy, Brym, Btym
Btym, Brym, Brym, Brym, Brym, Brym, Brym, Btym, Btym, Btym, Btym, Btym, Btym, Btym, Btym, Btyb, Btyb, Btyb, Brym^Sy|, Btyb, Btyb, Btyb, Btyb, Btyb, Btym, Btym, Btym, Btym, Btym, Btym, Brym, Btym, Brym, Btym, Brym, Brym, Btyb, Brym^Bryb, Brym, Brym^Bryb, Brym, Brym
Btyb, Brym, Brym, Brym, Brym, Brym, Brym, Brym, Brym, Btym, Btym, Btym, Btym, Btym, Btym, Btym, Btym, Btym, Brym^Sy|, Btym, Btym, Btym, Btym, Btym, Btym, Btym, Btym, Btym, Btym, Btym, Btyb, Brym, Btyb, Brym, Btyb, Brym, Btym, Brym, Brym, Btyb, Brym, Brym
Btym, Btyb, Btyb, Btyb, Btyb, Brym, Btyb, Btyb, Brym^Sy|, Btyb, Btym, Btym, Btym, Btym, Btym, Btym, Btym, Btym, Brym^Sy|, Btym, Btym, Btym, Btym, Btym, Btym, Btym, Btym, Btym, Brym^Vymb, Btym, Btym, Btym, Btym, Btyb, Btym, Btyb, Btym, Brym, Btyb, Btym, Btyb, Brym
Btym, Btym, Btym, Btym, Btym, Btyb, Btym, Btym, Brym^Sy|, Btym, Btym, Brym, Brym, Btym, Btym, Btym, Btym, Btym, Brym^Sy|, Btym, Btym, Btym, Btym, Btym, Btym, Btym, Btym, Brym, Brym, Brym, Brym, Brym, Btym, Btym, Btym, Btym, Btym, Brym^Sy|, Btym, Btym, Btym, Brym
Brym, Btym, Btym, Btym, Btym, Btym, Btym, Btym, Brym, Btym, Brym, Brym, Brym, Brym, Brym, Btym, Btym, Btym, Brym^Xo, Btym, Btym, Btym, Btym, Btym, Btym, Btym, Btym, Brym, Brym, Btyb, Brym, Gg, Rrc^Fynt, Btym, Brym, Btym, Btym, Brym, Brym, Btym, Btym, Btym
Brym, Brym, Wwt^Vyth, Wwt^Vyth, Wwt^Vyth, Btym, Brym, Brym, Brym, Brym, Brym, Brym, Gg, Gg, Gg, Brym, Brym^Bryl, Cmy, Cmy, Cmy, Brym^Bryl, Brym, Btym, Brym, Btym, Btyb, Brym, Brym^Vymb, Brym, Btym, Brym, Gg, Gg, Gg, Brym, Brym, Brym, Brym, Brym, Brym^Vymb, Brym, Brym
Brym, Brym, Wwt^Vyth, Wwt^Vyth, Wwt^Vyth, Brym, Btyb, Brym, Brym, Brym^Vymb, Brym, Btyb, Gg, Rrc^Fynt, Gg, Brym, Brym, Brym, Brym, Brym, Brym, Brym, Brym, Brym, Brym, Btym, Btym, Brym, Btyb, Btym, Btyb, Brym, Brym, Brym, Btyb, Btyb, Btyb, Btyb, Btym^Sy|, Brym, Btym, Btym
Brym, Brym^Vymb, Brym, Wwt^Vyth, Brym, Brym, Btym, Brym, Brym, Brym, Brym, Btym, Brym, Gg, Brym, Brym, Btyb, Brym, Brym, Brym, Brym, Brym^Lymp, Brym, Brym, Brym, Btym, Btym, Btym, Btym, Btym, Btym, Btym, Btym, Btym, Btym, Btym, Btym, Btym, Btym^Sy|, Btym, Btym, Btym
Brym, Brym, Btyb, Brym, Btyb, Brym, Btym, Brym, Btyb, Brym, Brym, Btym, Brym, Brym, Brym, Brym, Btym, Brym, Btyb, Brym, Brym, Brym, Brym, Brym, Brym, Brym, Btym, Btym, Btym, Btym, Btym, Btym, Btym, Btym, Btym, Btym, Btym, Btym, Btym^Sy|, Btym, Btym, Btym
Btym, Btyb, Btym, Btym, Btym, Btym, Btym, Btym, Btym, Btym, Btym, Btym, Btym, Btyb, Brym, Btyb, Btym, Btyb, Btym, Btyb, Btym, Btym^Sy|, Btym, Btyb, Btym, Brym, Brym, Btym, Btym, Btym, Btym, Btym, Btym, Btym, Btym, Btym, Btym, Btym, Btym^Sy|, Btym, Btym, Brym
Brym, Btym, Btym, Btym, Btym, Btym, Brym, Btym, Btym, Btym, Btym, Btym, Btym, Btym, Btym, Btym, Btym, Btym, Btym, Btym, Btym, Btym^Sy|, Btym, Btym, Btym, Btym, Btym, Btym, Btym, Btym, Btym, Btym, Btym, Btym, Btym, Btym, Btym, Btym, Brym, Btym, Brym, Brym
Btym, Btym, Btym, Brym, Brym, Brym, Brym, Brym, Brym, Brym, Brym, Btym, Brym, Btym, Btym, Btym, Brym, Btym, Brym, Btym, Brym, Brym, Brym, Btym, Brym, Btym, Btym, Brym, Brym, Btym, Btym, Brym, Brym, Brym^Vymb, Brym, Brym, Brym, Brym, Brym, Brym, Brym^Vymb, Brym
Brym, Btym, Brym, Brym, Brym, Brym, Kpy^Xo, Kpy^Xo, Kpy^Xo, Brym, Brym, Brym, Brym, Btym, Btyb, Brym, Brym, Brym^Vymb, Btyb, Brym, Ww, Ww, Ww, Brym, Brym, Brym, Brym, Brym^Vymb, Brym, Brym, Btym, Brym, Brym, Brym, Brym, Brym, Brym, Brym^Vymb, Brym, Brym, Brym, Brym
Brym, Brym, Brym, Brym, Kpy^Xo, Kpy^Xo, Cpy, Cpy, Cpy, Kpy^Xo, Kpy^Xo, Brym, Brym, Btym, Btym, Brym, Brym, Brym, Btym, Brym, Ww, Ww^Fynt, Ww, Brym, Brym, Btyb, Brym, Brym, Brym^Vymb, Brym, Btym, Btym, Btym, Brym, Btym, Btyb, Brym, Brym, Btym^Sy|, Btyb, Btym, Brym
Brym, Brym, Kpy^Xo, Kpy^Xo, Cpy, Cpy, Rrc, Rrc^Bryl, Rrc, Cpy, Cpy, Kpy^Xo, Kpy^Xo, Brym, Btym, Brym, Brym^Vymb, Brym, Btym, Brym, Brym, Ww, Brym, Brym, Brym, Btym, Brym, Brym, Brym, Brym, Btym, Brym, Brym, Btym, Brym, Btym, Btym, Btym, Brym, Btym, Brym, Btym
Brym, Brym, Kpy^Xo, Cpy, Rrc^Bryl, Rrc, Rrc, Rrc, Rrc, Rrc, Rrc^Bryl, Cpy, Kpy^Xo, Brym, Btym, Brym, Brym, Brym, Btym, Brym, Brym, Brym, Brym, Brym^Vymb, Brym, Btym, Brym, Brym, Btym, Btym, Brym, Brym, Brym, Brym, Brym, Brym, Brym^Vymb, Brym, Brym, Brym, Brym, Brym
Brym, Brym, Kpy^Xo, Cpy, Rrc, Rrc, Rrc, Rrc, Rrc, Rrc, Rrc, Cpy, Kpy^Xo, Brym, Brym, Btym, Btym, Brym, Btym, Brym, Brym, Brym, Brym, Brym, Brym, Btym, Btym, Btym, Brym, Brym, Brym, Brym^Vymb, Brym, Brym, Brym^Vymb, Brym, Brym, Brym, Brym^Vymb, Brym, Brym^Bryu, Brym
Brym, Brym, Kpy^Xo, Cpy, Rrc^Bryl, Rrc, Rrc, Rrc, Rrc, Rrc, Rrc^Bryl, Cpy, Kpy^Xo, Brym, Brym, Brym, Brym, Btym, Btym, Btym, Btym, Btym^Sy|, Btym, Btym, Btym, Btym, Brym, Brym, Brym, Brym^Bryu, Brym, Brym, Brym^Vymb, Brym, Brym, Brym, Brym^Fynt, Brym, Brym, Brym, Brym^Vymb, Brym
Brym, Brym, Kpy^Xo, Cpy, Cpy, Rrc, Rrc, Rrc, Rrc, Rrc, Cpy^Xo, Cpy^Xo, Brym, Brym, Brym, Brym^Vypr, Brym, Brym, Btym, Brym, Brym, Brym, Brym, Brym, Brym, Brym, Brym, Brym, Brym, Brym, Brym, Brym, Brym, Brym, Brym, Brym, Brym, Brym, Brym, Brym, Brym, Brym
Brym, Brym, Brym, Kpy^Xo, Kpy^Xo, Cpy, Cpy, Rrc^Bryl, Cpy^Xo, Rrc^Gye, Brym, Brym, Brym, Brym, Brym, Brym, Brym, Brym, Btym, Brym, Btym, Brym, Brym, Brym, Brym^Bryu, Brym, Brym, Brym^Fynt, Brym, Btyb, Brym, Brym^Vymb, Brym, Brym^Vymb, Brym, Brym, Brym^Vymb, Brym, Brym, Brym^Vymb, Brym, Brym
Brym, Brym, Brym^Vypr, Brym, Brym, Kpy^Xo, Kpy^Xo, Cpy^Xo, Brym, Brym, Brym, Brym, Brym^Vypr, Brym, Brym, Brym^Vypr, Brym, Brym, Brym, Btym, Brym, Btym, Btym, Brym, Brym, Brym, Brym, Brym, Brym, Btym, Brym, Brym, Brym, Brym, Brym^Bryu, Brym, Brym, Brym, Brym, Brym, Brym, Brym
Btym, Brym, Brym, Brym, Brym, Brym, Brym, Brym, Brym, Brym, Brym, Brym, Brym, Brym, Btym, Brym, Brym, Brym, Brym, Brym, Brym, Brym, Brym, Btym, Btym, Brym, Btym^Sy|, Brym, Btym, Btym, Btym, Brym, Brym, Brym, Brym, Brym, Brym, Brym, Brym, Brym, Brym, Brym
Btym, Brym, Btym^Sy|, Brym, Btym^Sy|, Brym, Btyb^Sy|, Brym, Btym^Sy|, Brym, Btym^Sy|, Brym, Btym, Btym, Brym, Btym, Btym, Btym, Btym, Btyb, Brym, Brym^Vypr, Brym, Brym, Brym, Btym, Brym, Btym, Brym, Btym, Brym, Btym, Btym, Btym^Sy|, Btym, Btym^Sy|, Btym, Btym^Sy|, Btym, Btym^Sy|, Btym, Btym
Brym, Btym, Brym, Btym, Brym, Btym, Brym, Btym, Brym, Btym, Brym, Btym, Brym, Brym, Brym, Brym^Vypr, Brym, Brym, Brym, Btym, Brym, Brym, Brym, Brym^Vypr, Brym, Brym, Brym, Brym, Brym, Btym, Brym, Brym, Brym^Vypr, Brym, Brym^Vypr, Brym, Brym, Brym, Brym, Brym, Brym, Brym
Brym, Brym, Brym, Brym, Brym^Vypr, Brym, Brym, Brym, Brym^Vypr, Brym, Brym, Brym, Brym, Brym^Vypr, Brym, Brym, Brym^Vypr, Brym, Brym, Btym, Btym, Brym^Vypr, Brym, Brym, Brym, Brym, Brym^Vypr, Brym, Btym, Btym, Brym, Brym^Vypr, Brym, Brym, Brym, Brym, Brym, Brym^Vypr, Brym, Brym, Cmy, Cmy
Btym, Cmy, Cmy, Brym, Brym, Brym, Brym^Vypr, Brym, Brym, Brym, Brym^Vypr, Brym, Brym, Brym, Brym, Brym, Brym, Brym, Brym^Vypr, Brym, Brym, Btym, Btym, Brym, Brym^Sy|, Brym, Btym, Btym, Brym, Brym, Cmy, Brym, Cmy, Brym^Vypr, Cmy, Brym, Cmy, Brym, Cmy, Cmy, Btym, Btym
Rrc, Btym, Btym, Cmy, Cmy, Cmy, Cmy, Cmy, Kmy, Cmy, Cmy, Cmy, Kmy, Cmy, Cmy, Brym, Brym^Vypr, Brym, Brym, Brym, Brym, Brym, Brym, Btym, Brym, Btym, Brym, Brym, Cmy, Cmy, Btym, Kmy, Btym, Cmy, Btym, Cmy, Btym, Kmy, Btym, Btym, Rrc, Rrc
Mm, Rrc, Rrc, Btym, Btym, Btym, Btym, Btym, Btym, Btym, Btym, Btym, Btym, Btym, Btym, Cmy, Cmy, Brym, Cmy, Brym, Brym, Brym, Brym, Brym, Cmy, Brym, Cmy, Cmy, Btym, Btym, Btym, Btym, Btym, Btym, Btym, Btym, Btym, Btym, Btym, Rrc, Mm, Mm
Mm, Mm, Mm, Rrc, Rrc, Rrc, Rrc, Rrc, Btym, Btym, Btym, Btym, Btym, Btym, Btym, Btym, Btym, Kmy, Btym, Kmy, Brym^Sy|, Kmy, Brym^Sy|, Kmy, Btym, Kmy, Btym, Btym, Btym, Btym, Rrc, Btym, Rrc, Btym, Rrc, Btym, Rrc, Btym, Rrc, Rrc, Mm, Mm
Mm, Mm, Mm, Rrc, Rrc, Rrc, Rrc, Rrc, Rrc, Rrc, Rrc, Rrc, Rrc, Rrc, Btym, Btym, Btym, Btym, Btym, Btym, Brym^Sy|, Btym, Brym^Sy|, Btym, Btym, Btym, Btym, Btym, Rrc, Rrc, Rrc, Rrc, Rrc, Rrc, Rrc, Rrc, Mm, Rrc, Mm, Mm, Mm, Mm
Mm, Mm, Mm, Mm, Mm, Rrc, Mm, Rrc, Mm, Rrc, Rrc, Rrc, Rrc, Rrc, Rrc, Btym, Btym, Btym, Btym, Btym, Brym^Sy|, Btym, Brym^Sy|, Btym, Btym, Btym, Btym, Btym, Rrc, Rrc, Rrc, Rrc, Rrc, Rrc, Mm, Mm, Mm, Mm, Mm, Mm, Mm, Mm
Mm^Xm, Mm, Mm, Mm, Mm, Mm, Mm, Mm, Mm, Mm, Mm, Rrc, Rrc, Rrc, Rrc, Btym, Btym, Btym, Btym, Btym, Brym^Xo, Btym, Brym^Xo, Btym, Btym, Btym, Btym, Rrc, Rrc, Rrc, Mm, Mm, Mm, Mm, Mm, Mm, Mm, Mm, Mm^Xm, Mm^Xm, Mm^Xm, Mm^Xm
Mm^Xm, Mm^Xm, Mm, Mm, Mm, Mm, Mm, Mm, Mm, Mm, Mm, Rrc, Rrc, Rrc, Rrc, Rrc, Rrc, Btym, Cmy, Btym, Cmy, Btym, Cmy, Btym, Cmy, Btym, Rrc, Rrc, Rrc, Rrc, Mm, Mm, Mm, Mm, Mm, Mm, Mm^Xm, Mm^Xm, Mm^Xm, Mm^Xm, Mm^Xm, Mm^Xm
Mm^Xm, Mm^Xm, Mm^Xm, Mm^Xm, Mm^Xm, Mm, Mm^Xm, Mm, Mm, Mm, Mm, Mm, Mm, Rrc, Rrc, Rrc, Rrc, Rrc, Rrc, Cmy, Rrc, Cmy, Rrc, Cmy, Rrc, Rrc, Rrc, Rrc, Rrc, Rrc, Mm, Mm, Mm, Mm, Mm^Xm, Mm^Xm, Mm^Xm, Mm^Xm, Mm^Xm, Mm^Xm, Mm^Xm, Mm^Xm
Mm^Xm, Mm^Xm, Mm^Xm, Mm^Xm, Mm^Xm, Mm^Xm, Mm^Xm, Mm^Xm, Mm^Xm, Mm, Mm, Mm, Mm, Mm, Mm, Rrc, Rrc, Rrc, Rrc, Rrc, Rrc, Rrc, Rrc, Rrc, Rrc, Rrc, Rrc, Rrc, Mm, Mm, Mm, Mm, Mm, Mm, Mm^Xm, Mm^Xm, Mm^Xm, Mm^Xm, Mm^Xm, Mm^Xm, Mm^Xm, Mm^Xm
Mm^Xm, Mm^Xm, Mm^Xm, Mm^Xm, Mm^Xm, Mm^Xm, Mm^Xm, Mm^Xm, Mm^Xm, Mm, Mm, Mm, Mm, Mm, Mm, Mm, Mm, Rrc, Rrc, Rrc, Rrc, Rrc, Rrc, Rrc, Rrc, Rrc, Mm, Mm, Mm, Mm, Mm, Mm, Mm^Xm, Mm^Xm, Mm^Xm, Mm^Xm, Mm^Xm, Mm^Xm, Mm^Xm, Mm^Xm, Mm^Xm, Mm^Xm
Mm^Xm, Mm^Xm, Mm^Xm, Mm^Xm, Mm^Xm, Mm^Xm, Mm^Xm, Mm^Xm, Mm^Xm, Mm^Xm, Mm^Xm, Mm, Mm, Mm, Mm, Mm, Mm, Mm, Rrc, Btym, Rrc, Rrc, Rrc, Btym, Rrc, Mm, Mm, Mm, Mm, Mm, Mm, Mm^Xm, Mm^Xm, Mm^Xm, Mm^Xm, Mm^Xm, Mm^Xm, Mm^Xm, Mm^Xm, Mm^Xm, Mm^Xm, Mm^Xm
Mm^Xm, Mm^Xm, Mm^Xm, Mm^Xm, Mm^Xm, Mm^Xm, Mm^Xm, Mm^Xm, Mm^Xm, Mm^Xm, Mm^Xm, Mm, Mm, Mm, Mm, Mm, Mm, Mm, Mm, Rrc, Rrc, 1 Rrc, Rrc, Rrc, Mm, Mm, Mm, Mm, Mm, Mm, Mm^Xm, Mm^Xm, Mm^Xm, Mm^Xm, Mm^Xm, Mm^Xm, Mm^Xm, Mm^Xm, Mm^Xm, Mm^Xm, Mm^Xm, Mm^Xm
Mm^Xm, Mm^Xm, Mm^Xm, Mm^Xm, Mm^Xm, Mm^Xm, Mm^Xm, Mm^Xm, Mm^Xm, Mm^Xm, Mm^Xm, Mm^Xm, Rrc, Mm, Rrc, Mm, Mm, Mm, Mm, Rrc, Rrc, Rrc, Rrc, Mm, Rrc, Mm, Mm, Mm, Mm, Mm, Mm^Xm, Mm^Xm, Mm^Xm, Mm^Xm, Mm^Xm, Mm^Xm, Mm^Xm, Mm^Xm, Mm^Xm, Mm^Xm, Mm^Xm, Mm^Xm
