Brym, Brym, Gg, Brym, Brym, Btym, Btym, Btym, Btym, Btyb, Btyb, Brym, Brym, Brym, Btym, Btym, Btym, Brym, Brym, Brym, Brym, Brym, Btyb, Btyb, Brym, Brym, Brym, Brym, Btyb, Brym, Btym, Brym, Btym, Btym, Btym, Btym, Btym, Btym, Wuyb, Btym, Btym, Btym
Brym, Gg^Efm, Gg^Fet, Gg^Efm, Brym, Btym, Btym, Btym, Btym, Btym, Btym, Btyb, Btyb, Brym, Brym, Btym, Brym, Brym^Lymp, Brym, Brym, Brym, Brym, Btym, Btym, Brym, Brym, Btyb, Btyb, Btym, Btym, Btym, Btym, Btym, Btym, Btym, Btym, Btym, Wuyb, Wuyb, Wuyb, Btym, Btym
Brym, Gg, Gg^Efm, Gg^Efm, Brym, Brym, Btym, Btym, Btym, Btym, Btym, Btym, Btym, Btyb, Btyb, Brym, Btyb, Brym, Brym, Brym, Brym, Brym^Lymp, Brym, Brym, Btyb, Btyb, Btym, Btym, Btym, Btym, Btym, Btym, Btym, Btym, Btym, Btym, Brym, Cpy, Cpy, Cpy, Brym, Btym
Btyb, Brym, Brym, Brym, Brym, Brym, Brym, Btym, Btym, Btym, Btym, Btym, Btym, Btym, Btym, Btyb, Btyb, Btyb, Brym^Sy|, Btyb, Btyb, Btyb, Btyb, Btyb, Btym, Btym, Btym, Btym, Btym, Btym, Brym, Btym, Brym, Btym, Brym, Brym, Btyb, Brym^Bryb, Brym, Brym^Bryb, Brym, Brym
Btym, Btyb, Btyb, Btyb, Btyb, Brym, Rrc^Lymp, Brym, Brym, Btym, Btym, Btym, Btym, Btym, Btym, Btym, Btym, Btym, Brym^Sy|, Btym, Btym, Btym, Btym, Btym, Btym, Btym, Btym, Btym, Btym, Btym, Btyb, Brym, Btyb, Brym, Btyb, Brym, Btym, Brym, Brym, Btyb, Brym, Brym
Btym, Btym, Btym, Btym, Btym, Btyb, Btym, Btyb, Brym^Sy|, Btyb, Btym, Btym, Btym, Btym, Btym, Btym, Btym, Btym, Brym^Sy|, Btym, Btym, Btym, Btym, Btym, Btym, Btym, Btym, Btym, Brym^Vymb, Btym, Btym, Btym, Btym, Btyb, Btym, Btyb, Btym, Brym, Btyb, Btym, Btyb, Brym
Btym, Btym, Btym, Btym, Btym, Btym, Btym, Btym, Brym^Sy|, Btym, Btym, Brym, Brym, Btym, Btym, Btym, Btym, Btym, Brym^Sy|, Btym, Btym, Btym, Btym, Btym, Btym, Btym, Btym, Brym, Brym, Brym, Brym, Brym, Btym, Btym, Btym, Btym, Btym, Brym^Sy|, Btym, Btym, Btym, Brym
Brym, Btym, Btym, Btym, Btym, Btym, Btym, Btym, Brym, Btym, Brym, Brym, Brym, Brym, Brym, Btym, Btym, Btym, Brym^Xo, Btym, Btym, Btym, Btym, Btym, Btym, Btym, Btym, Brym, Brym, Btyb, Brym, Gg^Efm, Rrc^Fynt, Btym, Brym, Btym, Btym, Brym, Brym, Btym, Btym, Btym
Brym, Brym, Wwt^Vyth, Wwt^Vyth, Wwt^Vyth, Btym, Brym, Brym, Brym, Brym, Brym, Brym, Gg, Gg, Gg^Efm, Brym, Brym^Bryl, Cmy, Cmy, Cmy, Brym^Bryl, Brym, Btym, Brym, Btym, Btyb, Brym, Brym^Vymb, Brym, Btym, Brym, Gg, Gg^Efm, Gg, Brym, Brym, Brym, Brym, Brym, Brym^Vymb, Brym, Brym
Brym, Brym, Wwt^Vyth, Wwt^Vyth, Wwt^Vyth, Brym, Btyb, Brym, Brym, Brym^Vymb, Brym, Btyb, Gg^Efm, Rrc^Fynt, Gg, Brym, Brym, Brym, Brym, Brym, Brym, Brym, Brym, Brym^Lymp, Brym, Btym, Btym, Brym, Btyb, Btym, Btyb, Brym, Brym, Brym, Btyb, Btyb, Btyb, Btyb, Btym^Sy|, Brym, Btym, Btym
Brym, Brym^Vymb, Brym, Wwt^Vyth, Brym, Brym, Btym, Brym, Brym, Brym, Brym, Btym, Brym, Gg^Efm, Brym, Brym, Btyb, Brym, Brym, Brym, Brym, Brym, Brym, Brym, Brym, Btym, Btym, Btym, Btym, Btym, Btym, Btym, Btym, Btym, Btym, Btym, Btym, Btym, Btym^Sy|, Btym, Btym, Btym
Brym, Brym, Btyb, Brym, Btyb, Brym, Btym, Brym, Btyb, Brym, Brym, Btym, Brym, Brym, Brym, Brym, Btym, Brym, Btyb, Brym, Brym, Brym, Brym, Brym, Brym, Brym, Btym, Btym, Btym, Btym, Btym, Btym, Btym, Btym, Btym, Btym, Btym, Btym, Btym^Sy|, Btym, Btym, Btym
Btym, Btyb, Btym, Btym, Btym, Btym, Btym, Btym, Btym, Btym, Btym, Btym, Btym, Btyb, Brym, Btyb, Btym, Btyb, Btym, Btyb, Btym, Btym^Sy|, Btym, Btyb, Btym, Brym, Brym^Lymp, Btym, Btym, Btym, Btym, Btym, Btym, Btym, Btym, Btym, Btym, Btym, Btym^Sy|, Btym, Btym, Brym
Brym, Btym, Btym, Btym, Btym, Btym, Rr, Btym, Btym, Btym, Btym, Btym, Btym, Btym, Btym, Btym, Btym, Btym, Btym, Btym, Btym, Btym^Sy|, Btym, Btym, Btym, Btym, Btym, Btym, Btym, Btym, Btym, Btym, Btym, Btym, Btym, Btym, Btym, Btym, Brym, Btym, Brym, Brym
Btym, Btym, Btym, Brym, Rr^Es, Rr, Rr, Rr, Rr, Rr, Rr^Es, Btym, Rrc, Btym, Btym, Btym, Brym, Btym, Brym, Btym, Brym, Brym, Brym, Btym, Brym, Btym, Btym, Brym, Brym, Btym, Btym, Brym, Brym, Brym^Vymb, Brym^Es, Brym, Brym, Brym, Brym, Brym^Es, Brym^Vymb, Brym
Brym, Btym, Rr, Rr, Rr^Es, Rr, Kpy^Xo, Kpy^Xo, Kpy^Xo, Rr, Rr^Es, Rr^Es, Rrc, Btym, Btyb, Brym, Brym, Brym^Vymb, Btyb, Brym, Ww, Ww, Ww, Brym, Brym, Brym, Brym, Brym^Vymb, Brym, Brym, Btym, Brym^Es, Brym, Brym, Brym, Brym, Brym, Brym^Vymb, Brym, Brym, Brym, Brym
Brym, Rr, Rr, Rr^Es, Kpy^Xo, Kpy^Xo, Cpy, Cpy, Cpy, Kpy^Xo, Kpy^Xo, Rr, Rr, Btym, Btym, Brym, Brym, Brym, Btym, Brym, Ww, Ww^Fynt, Ww, Brym, Brym, Btyb, Brym, Brym, Brym^Vymb, Brym, Btym, Btym, Btym, Brym, Btym, Btyb, Brym, Brym, Btym^Sy|, Btyb, Btym, Brym
Rr, Rr^Es, Kpy^Xo, Kpy^Xo, Cpy, Cpy, Rrc^Edb, Rrc^Bryl, Rrc^Edb, Cpy, Cpy, Kpy^Xo, Kpy^Xo, Rr, Btym, Brym, Brym^Vymb, Brym, Btym, Brym, Brym, Ww, Brym, Brym, Brym, Btym, Brym, Brym, Brym, Brym, Btym, Rrc, Rrc^Es, Btym, Rrc, Btym, Btym, Btym, Rrc, Btym, Brym, Btym
Rr, Rr^Es, Kpy^Xo, Cpy, Rrc^Bryl, Rrc^Edb, Rrc, Rrc^Edb, Rrc^Edb, Rrc, Rrc^Bryl, Cpy, Kpy^Xo, Rr, Btym, Brym, Brym, Brym, Btym, Brym, Brym, Brym, Brym, Brym^Vymb, Brym, Btym, Brym, Brym, Btym, Btym, Brym, Rrc, Rrc, Rrc, Rrc^Es, Rrc, Rrc^Vymb, Rrc, Rrc, Rrc, Rrc, Brym
Rrc, Rrc^Es, Kpy^Xo, Cpy, Rrc^Edb, Rrc, Rrc^Edb, Rrc^Edb, Rrc^Edb, Rrc, Rrc, Cpy, Kpy^Xo, Rr, Rr^Edb, Btym, Btym, Brym, Btym, Brym, Brym, Brym, Brym, Brym, Brym, Btym, Btym, Btym, Brym, Brym, Brym, Brym^Vymb, Rrc, Rrc, Rrc^Vymb, Rrc, Rrc, Rrc, Rrc^Vymb, Rrc, Rrc^Bryu, Brym
Rrc^Es, Rrc, Kpy^Xo, Cpy, Rrc^Bryl, Rrc, Rrc^Edb, Rrc^Edb, Rrc, Rrc^Edb, Rrc^Bryl, Cpy, Kpy^Xo, Rr^Edb, Rr^Edb, Rrc, Rrc, Btym, Btym, Btym, Btym, Btym^Sy|, Btym, Btym, Btym, Btym, Brym, Brym, Brym, Brym^Bryu, Brym, Brym, Brym^Vymb, Rrc, Rrc, Rrc, Rrc^Fynt, Rrc, Rrc^Es, Rrc, Rrc^Vymb, Rrc
Rrc^Es, Rr, Kpy^Xo, Cpy, Cpy, Rrc, Rrc, Rrc, Rrc^Edb, Rrc, Cpy^Xo, Cpy^Xo, Rrc^Edb, Rr, Rrc, Rr^Vypr, Rrc^Es, Rrc, Btym, Brym, Brym, Brym, Brym, Brym, Brym, Brym^Es, Brym^Es, Brym^Es, Brym, Brym, Brym, Brym, Rrc, Rrc, Rrc^Es, Rrc, Rrc, Rrc^Es, Rrc, Rrc, Rrc^Es, Rrc
Rr, Rr^Es, Rr^Es, Kpy^Xo, Kpy^Xo, Cpy, Cpy, Rrc^Bryl, Cpy^Xo, Rrc^Gye, Rrc^Es, Rrc^Edb, Rrc^Edb, Rrc, Rrc, Rrc, Rrc, Rrc, Btym, Brym, Btym, Brym, Brym^Es, Brym, Brym^Bryu, Brym, Brym, Brym^Fynt, Brym, Btyb, Brym, Brym^Vymb, Brym, Rrc^Vymb, Rrc, Rrc, Rrc^Vymb, Rrc, Rrc, Rrc^Vymb, Rrc, Rrc
Rrc, Rr, Rr^Vypr, Rr, Rr, Kpy^Xo, Kpy^Xo, Cpy^Xo, Rrc, Rrc^Es, Rrc, Rrc, Rrc^Vypr, Rrc, Brym, Rrc^Vypr, Rrc^Es, Rrc, Rrc, Btym, Rrc, Btym, Btym, Brym, Brym, Brym, Brym, Brym^Es, Brym, Btym, Brym, Brym, Brym, Brym^Es, Rrc^Bryu, Rrc, Rrc, Rrc, Brym, Brym, Rrc, Rrc
Btym, Rrc, Brym, Rrc, Brym, Rr, Rrc, Rrc, Brym, Rrc^Edb, Brym, Rrc, Brym, Brym, Btym, Brym, Brym, Rrc^Es, Rrc^Es, Rrc^Es, Rrc^Es, Rrc, Rrc, Btym, Btym, Brym, Btym^Sy|, Brym, Btym, Btym, Btym, Brym, Brym, Brym, Brym, Brym, Brym, Brym, Brym, Brym^Es, Brym, Brym
Btym, Brym, Btym^Sy|, Brym, Btym^Sy|, Brym, Btyb^Sy|, Brym, Btym^Sy|, Brym, Btym^Sy|, Brym, Btym, Btym, Rr, Btym, Btym, Brym, Brym, Rrc, Rrc, Rrc^Vypr, Rrc, Rrc, Rrc, Btym, Rrc, Btym, Rrc, Btym, Re, Btym, Btym, Btym^Sy|, Btym, Btym^Sy|, Btym, Btym^Sy|, Btym, Btym^Sy|, Btym, Btym
Rr, Btym, Rr, Btym, Rr, Btym, Rr, Btym, Rr, Btym, Rr, Btym, Re^Edb, Re, Rr, Rr^Vypr, Rr, Btym, Btym, Brym, Brym, Rrc, Rrc, Rrc^Vypr, Rrc^Es, Rrc^Es, Rrc, Rrc, Brym, Btym, Re, Re^Es, Re^Es, Rr, Rr^Vypr, Rr, Rr, Rr, Rr^Edb, Rr, Rr^Es, Rr
Rr, Rr, Rr, Re, Re^Vypr, Rr, Re^Edb, Rr^Edb, Rr^Vypr, Rr, Re^Es, Rr^Edb, Re^Edb, Rr^Vypr, Re^Es, Re, Rr^Vypr, Re^Es, Rr^Es, Btym, Btym, Brym^Vypr, Brym, Rrc, Rrc, Rrc, Brym, Brym, Btym, Btym, Rr^Es, Re^Vypr, Re^Edb, Re^Edb, Rr^Es, Rr^Es, Re^Edb, Rrc^Vypr, Rr, Rr^Es, Cmy, Cmy
Btym, Cmy, Cmy, Re, Rr, Re^Edb, Rrc^Vypr, Re, Rr^Edb, Re, Rr^Vypr, Re, Rr, Re^Edb, Rr^Es, Re, Re^Edb, Rr^Edb, Rrc^Vypr, Rr, Rr, Btym, Btym, Brym, Brym^Sy|, Brym, Btym, Btym, Rr^Es, Rr^Es, Cmy, Rr, Cmy, Rrc^Vypr, Cmy, Rr^Es, Cmy, Rr, Cmy, Cmy, Btym, Btym
Rrc, Btym, Btym, Cmy, Cmy, Cmy, Cmy, Cmy, Kmy, Cmy, Cmy, Cmy, Kmy, Cmy, Cmy, Rr, Rrc^Vypr, Rr^Edb, Rr, Rr^Es, Rr^Es, Rr, Rr, Btym, Rr, Btym, Rr, Rr^Vypr, Cmy, Cmy, Btym, Kmy, Btym, Cmy, Btym, Cmy, Btym, Kmy, Btym, Btym, Rrc^Es, Rrc
Mm, Rrc, Rrc^Es, Btym, Btym, Btym, Btym, Btym, Btym, Btym, Btym, Btym, Btym, Btym, Btym, Cmy, Cmy, Rr, Cmy, Rr, Rr, Rr^Es, Rr, Rr, Cmy, Rr, Cmy, Cmy, Btym, Btym, Btym, Btym, Btym, Btym, Btym, Btym, Btym, Btym, Btym, Rrc, Mm, Mm
Mm, Mm^Xm, Mm, Rrc, Rrc, Rrc^Es, Rrc^Es, Rrc, Btym, Btym, Btym, Btym, Btym, Btym, Btym, Btym, Btym, Kmy, Btym, Kmy, Brym^Sy|, Kmy, Brym^Sy|, Kmy, Btym, Kmy, Btym, Btym, Btym, Btym, Rrc^Es, Btym, Rrc, Btym, Rrc, Btym, Rrc, Btym, Rrc^Es, Rrc^Es, Mm, Mm
Mm, Mm, Mm^Xm, Rrc, Rrc, Rrc^Es, Rrc, Rrc, Rrc, Rrc, Rrc, Rrc, Rrc^Es, Rrc, Btym, Btym, Btym, Btym, Btym, Btym, Brym^Sy|, Btym, Brym^Sy|, Btym, Btym, Btym, Btym, Btym, Rrc, Rrc^Es, Rrc^Es, Rrc^Es, Rrc, Rrc, Mm, Rrc, Mm, Rrc^Es, Mm, Mm, Mm, Mm
Mm, Mm, Mm, Mm^Xm, Mm, Rrc, Mm^Xm, Rrc, Mm, Rrc, Rrc, Rrc, Rrc^Es, Rrc^Es, Rrc, Btym, Btym, Btym, Btym, Btym, Brym^Sy|, Btym, Brym^Sy|, Btym, Btym, Btym, Btym, Btym, Rrc, Rrc, Mm, Rrc^Es, Rrc^Es, Mm, Mm, Mm, Mm, Mm, Mm, Mm, Mm, Mm
Mm^Xm, Mm, Mm, Mm^Xm, Mm, Mm, Mm^Xm, Mm^Xm, Mm, Mm, Mm, Rrc, Rrc, Rrc, Rrc, Btym, Btym, Btym, Btym, Btym, Brym^Xo, Btym, Brym^Xo, Btym, Btym, Btym, Btym, Rrc, Rrc^Es, Mm, Mm, Mm, Mm, Mm, Mm, Mm, Mm, Mm, Mm, Mm^Xm, Mm^Xm, Mm^Xm
Mm^Xm, Mm^Xm, Mm, Mm, Mm, Mm, Mm, Mm^Xm, Mm^Xm, Mm, Mm, Rrc, Rrc, Rrc, Mm, Rrc, Rrc^Es, Btym, Cmy, Btym, Cmy, Btym, Cmy, Btym, Cmy, Btym, Rrc, Rrc, Rrc^Es, Mm, Mm^Xm, Mm^Xm, Mm^Xm, Mm, Mm, Mm, Mm, Mm, Mm, Mm^Xm, Mm^Xm, Mm^Xm
Mm^Xm, Mm^Xm, Mm^Xm, Mm^Xm, Mm^Xm, Mm, Mm^Xm, Mm, Mm, Mm, Mm, Mm, Mm^Xm, Mm, Mm, Rrc, Rrc, Rrc, Rrc^Es, Cmy, Rrc, Cmy, Rrc, Cmy, Rrc, Rrc^Es, Rrc, Rrc, Mm, Mm, Mm, Mm^Xm, Mm^Xm, Mm^Xm, Mm^Xm, Mm^Xm, Mm^Xm, Mm^Xm, Mm^Xm, Mm, Mm, Mm^Xm
Mm, Mm, Mm, Mm^Xm, Mm^Xm, Mm^Xm, Mm^Xm, Mm^Xm, Mm, Mm, Mm, Mm, Mm, Mm, Mm, Mm, Rrc, Rrc^Es, Rrc, Rrc, Rrc, Rrc, Rrc, Rrc, Rrc, Rrc^Es, Rrc^Es, Mm, Mm, Mm, Mm, Mm^Xm, Mm^Xm, Mm^Xm, Mm^Xm, Mm^Xm, Mm^Xm, Mm^Xm, Mm^Xm, Mm, Mm, Mm
Mm^Xm, Mm, Mm, Mm, Mm^Xm, Mm^Xm, Mm^Xm, Mm^Xm, Mm^Xm, Mm, Mm, Mm^Xm, Mm^Xm, Mm, Mm, Mm, Mm, Rrc, Rrc, Rrc, Rrc, Rrc, Rrc, Rrc, Rrc, Rrc, Mm, Mm, Mm, Mm, Mm, Mm, Mm^Xm, Mm^Xm, Mm, Mm, Mm, Mm^Xm, Mm, Mm, Mm, Mm
Mm^Xm, Mm^Xm, Mm, Mm, Mm^Xm, Mm^Xm, Mm^Xm, Mm^Xm, Mm, Mm, Mm^Xm, Mm, Mm, Mm^Xm, Mm, Mm, Mm, Mm, Rrc, Btym, Rrc, Rrc^Es, Rrc, Btym, Rrc, Mm, Mm, Mm^Xm, Mm^Xm, Mm, Mm^Xm, Mm^Xm, Mm^Xm, Mm^Xm, Mm^Xm, Mm, Mm, Mm, Mm^Xm, Mm^Xm, Mm^Xm, Mm^Xm
Mm^Xm, Mm^Xm, Mm^Xm, Mm^Xm, Mm^Xm, Mm^Xm, Mm^Xm, Mm^Xm, Mm^Xm, Mm, Mm^Xm, Mm, Mm, Mm^Xm, Mm, Mm, Mm, Mm, Mm, Rrc^Es, Rrc^Es, 1 Rrc, Rrc^Es, Rrc, Mm, Mm, Mm^Xm, Mm, Mm^Xm, Mm^Xm, Mm^Xm, Mm^Xm, Mm^Xm, Mm^Xm, Mm^Xm, Mm^Xm, Mm^Xm, Mm^Xm, Mm^Xm, Mm^Xm, Mm^Xm, Mm^Xm
Mm^Xm, Mm^Xm, Mm^Xm, Mm^Xm, Mm^Xm, Mm^Xm, Mm^Xm, Mm^Xm, Mm^Xm, Mm^Xm, Mm^Xm, Mm^Xm, Rrc, Mm, Rrc, Mm, Mm, Mm, Mm, Rrc, Rrc, Rrc^Es, Rrc, Mm, Rrc, Mm, Mm, Mm^Xm, Mm^Xm, Mm^Xm, Mm^Xm, Mm^Xm, Mm^Xm, Mm^Xm, Mm^Xm, Mm^Xm, Mm^Xm, Mm^Xm, Mm^Xm, Mm^Xm, Mm^Xm, Mm^Xm
