Xu, Xu, Xu, Xu, Xu, Xu, Xu, Xu, Xu, Xu, Xu, Xu, Xu, Xu, Xu, Ha, Aa^Fpa, Ai, Ai, Ai, Ai, Ai, Ai, Ai, Ai, Ai, Ai, Ms, Ms, Ms, Ai, Ai, Ai, Ai, Ai, Ai, Ai
Xu, Xu, Xu, Xu, Xu, Xu, Xu, Xu, Xu, Xu, Xu, Xu, Xu, Xu, Xu, Ha^Fpa, Ha^Fpa, Ha, Ha, Ai, Ai, Ai, Ai, Ai, Ai, Ai, Ms, Ms, Ms, Ai, Ai, Ai, Ai, Ai, Ai, Ai, Ai
Xu, Xu, Xu, Xu, Ai, Xu, Xu, Xu, Xu, Xu, Xu, Xu, Xu, Xu, Xu, Xu, Xu, Ms, Ha^Fpa, Ai, Ai, Ai, Ai, Ai, Ms, Ai, Ms, Ms, Ms, Ai, Ai, Ai, Ai, Ai, Ai, Ai, Ai
Xu, Xu, Xu, Ai, Ayb, Ai, Xu, Ai, Ai, Ai, Xu, Xu, Xu, Xu, Xu, Xu, Xu, Ms, Ms, Ha^Fpa, Ai, Ai, Ai, Ai, Ms, Ms, Ms^Xm, Ms^Xm, Ms^Xm, Ai, Ai, Ai, Ai, Ai, Ai, Ai, Ms
Xu, Xu, Xu, Ai, Ai, Ai, Ai, Ai, Xu, Xu, Xu, Xu, Xu, Xu, Xu, Xu, Xu, Ms, Ms, Ha^Fpa, Ha, Ai, Ai, Ms, Ms, Ms^Xm, Ms^Xm, Ms^Xm, Ms^Xm, Ai, Ai, Ai, Ai, Ai, Ms, Ms, Ms
Xu, Xu, Xu, Xu, Ai, Ai, Ai, Ai, Ai, Xu, Xu, Ai, Xu, Xu, Xu, Xu, Ms, Ms, Ha^Fpa, Ha, Ai, Ai, Ai, Ai, Ms, Ms^Xm, Ms, Ms^Xm, Ms, Ai, Ai, Ai, Ai, Ai, Ms, Ms, Ai
Xu, Xu, Xu, Ai, Xu, Xu, Xu, Ai, Ai, Xu, Ai, Ai, Ai, Xu, Xu, Xu, Aa^Fpa, Ms, Ha^Fpa, Ai, Ai, Ai, Ai, Ai, Ai, Ms, Ms, Ms, Ai, Ai, Ai, Ai, Ai, Ms, Ms, Ai, Ai
Xu, Xu, Xu, Ai, Xu, Xu, Xu, Ai, Ai, Ai, Xu, Ai, Xu, Xu, Xu, Xu, Xu, Ha^Fpa, Aa^Fpa, Ai, Ai, Ai, Ai, Ai, Ms, Ms, Ms, Ai, Ai, Ai, Ai, Ai, Ai, Ms, Ms, Ai, Ai
Xu, Xu, Xu, Xu, Xu, Xu, Ai, Xu, Ai, Xu, Ai, Xu, Xu, Xu, Xu, Xu, Xu, Ha^Fpa, Ai, Ai, Ai, Ai, Ai, Ai, Ai, Ms, Ms, Ai, Ai, Ai, Ai, Ai, Ms, Ms, Ms, Ai, Ai
Xu, Xu, Xu, Xu, Xu, Ai, Xu, Ai, Xu, Ai, Ai, Xu, Xu, Ha, Ha^Fpa, Xu, Ha, Ha, Ai, Ai, Ai, Ai, Ai, Ms, Ms, Ms, Ms, Ai, Ai, Ai, Ai, Ms, Ms, Ms, Ai, Ai, Ai
Xu, Xu, Xu, Xu, Xu, Xu, Xu, Ai, Ai, Xu, Ai, Ai, Ai, Ai, Ha, Ha^Fpa, Ha, Ai, Ai, Ai, Ai, Ai, Ms, Ms, Ms, Ms, Ai, Ms, Ai, Ai, Ms, Ms, Ai, Ms, Ai, Ai, Ai
Xu, Xu, Xu, Xu, Xu, Xu, Xu, Ai, Xu, Xu, Xu, Ai, Ai, Ai, Ai, Ha, Ai, Ai, Ai, Ai, Ai, Ai, Ai, Ai, Ai, Ai, Ai, Ai, Ai, Ai, Ms, Ms, Ai, Ai, Ai, Ai, Ai
Ha^Fpa, Xu, Xu, Xu, Xu, Xu, Xu, Xu, Ms, Xu, Xu, Xu, Ai, Ai, Ai, Ai, Ai, Ai, Ai, Ai, Ai, Ai, Ai, Ai, Ai, Ai, Ai, Ai, Ai, Ai, Ms, Ms, Ms, Ms, Ms, Ai, Ai
Ha^Fpa, Ha^Fpa, Ha^Fma, Xu, Ha^Fpa, Ms, Ms, Ms, Ms, Ms, Ha^Fma, Ha, Ai, Ai, Ai, Ai, Ai, Ai, Ai, Ai, Ai, Ai, Ai, Ai, Ai, Ai, Ai, Ai, Ai, Ai, Ai, Ms, Ms, Ms, Ms, Ai, Ai
Aa^Fpa, Aa^Fpa, Ha^Fpa, Ha^Fpa, Ha^Fpa, Ha^Fpa, Ha^Fma, Ms, Ha^Fpa, Ms, Ha^Fpa, Aa^Fpa, Ai, Ai, Ai, Ai, Ai, Ai, Ai, Ai, Ai, Ai, Ms, Ai, Ai, Ai, Ai, Ai, Ai, Ai, Ai, Ms, Ms, Ms, Ms, Ai, Ai
Aa^Fpa, Aa^Fma, Aa^Fpa, Aa, Aa^Fpa, Aa^Fma, Ha^Fpa, Ha^Fpa, Ha^Fma, Ha^Fpa, Aa^Fma, Ai, Ai, Ai, Ai, Ai, Ai, Ai, Ai, Ai, Ai, Ms, Ms, Ai, Ai, Ai, Ai, Ai, Ai, Ai, Ai, Ai, Ms, Ms, Ms, Ms, Ai
Ai, Ai, Ai, Ai, Ai, Aa^Fma, Ai, Aa^Fpa, Ai, Aa^Fpa, Ai, Ai, Ai, Ai, Ai, Ai, Ai, Ai, Ai, Ai, Ai, Ai, Ai, Ai, Ai, Ai, Ai, Ai, Ai, Ai, Ai, Ms, Ms, Ms, Ms, Ms, Ms
Ai, Ai, Ai, Ai, Ai, Ai, Ai, Ai, Ai, Ai, Ai, Ai, Ai, Ai, Ai, Ai, Ai, Ai, Ai, Ai, Ai, Ai, Ai, Ai, Ai, Ai, Ai, Ai, Ai, Ai, Ms, Ms, Ms^Xm, Ms^Xm, Ms^Xm, Ms^Xm, Ms^Xm
Ai, Ai, Ai, Ai, Ms, Ai, Ms, Ai, Ms, Ai, Ai, Ai, Ai, Ai, Ai, Ai, Ai, Ai, Ai, Ai, Ai, Ai, Ai, Ai, Ai, Ai, Ai, Ai, Ai, Ai, Ms, Ms, Ms^Xm, Ms^Xm, Ms^Xm, Ms^Xm, Ms^Xm
Ai, Ai, Ai, Ai, Ms, Ms, Ms, Ai, Ai, Ms, Ms, Ai, Ai, Ai, Ai, Ai, Ai, Ai, Ai, Ai, Ai, Ai, Ai, Ai, Ai, Ai, Ai, Ai, Ha, Ha, Ha, Ms, Ms, Ms^Xm, Ms^Xm, Ms^Xm, Ms^Xm
Ai, Ai, Ai, Ai, Ms, Ms, Ai, Ms, Ai, Ai, Ms, Ai, Ai, Ai, Ai, Ai, Ai, Ai, Ai, Ai, Ai, Ai, Ai, Ai, Ai, Ai, Ms, Ha, Ha, Ha, Cha, Cha, Cha, Cha, Cha, Ms^Xm, Ms
Ai, Ai, Ai, Ai, Ai, Ai, Ai, Ai, Ai, Ai, Ai, Ms, Ai, Ai, Ai, Ai, Ai, Ai, Ai, Ai, Ai, Ai, Ai, Ai, Ai, Ms, Ms, Ha, Ms, Cha, Cha, Cha, Cha, Cha, 2 Kha, Cha, Ms
Ai, Ai, Ai, Ai, Ai, Ai, Ai, Ai, Ai, Ai, Ms, Ms, Ms, Ms, Ai, Ai, Ai, Ai, Ai, Ai, Ai, Ai, Ms, Ms, Ms, Ms, Ms, Ms, Cha, Cha, Cha, Rrc, Rrc, Rrc, Rrc, Cha, Cha
Ai, Ai, Ai, Ai, Ai, Ai, Ms, Ms, Ms, Ai, Ms, Ms, Ms, Ms, Ai, Ai, Ai, Ai, Ai, Ai, Ai, Ai, Ai, Ai, Ms, Ms, Ms^Xm, Ms^Xm, Cha, Cha, Rrc, Rrc, Cha, Rrc, Rrc, Cha, Cha
Ai, Ai, Ai, Ai, Ai, Ai, Ms, Ms, Ms, Ai, Ms, Ms, Ms, Ms, Ai, Ai, Ai, Ai, Ai, Ai, Ai, Ai, Ms, Ai, Ai, Ms, Ms, Ms^Xm, Cha, 1 Kha, Rrc, Rrc, Cha, Cha, Cha, Cha, Cha
Ai, Ai, Ai, Ai, Ms, Ai, Ms, Ms, Ms, Ms, Ms, Ms, Ms, Ms, Ai, Ai, Ai, Ai, Ai, Ai, Ai, Ai, Ms, Ai, Ms, Ms, Ms, Ms^Xm, Ms^Xm, Cha, Cha, Rrc, Cha, Kha, Cha, Cha, Cha
Ai, Ai, Ai, Ms, Ms, Ms, Ai, Ms, Ms, Ms, Ms, Ms, Ai, Ms, Ai, Ai, Ai, Ai, Ai, Ai, Ai, Ms, Ms, Ms, Ms, Ms, Ms^Xm, Ms^Xm, Ms^Xm, Cha, Cha, Cha, Cha, Cha, Rrc, Rrc, Cha
