Xue, Xue, Xue, Xue, Xue, Xue, Qxua, Qxua, Qxua, Qxua, Qxua, Qxua, Qxua, Qxua, Qxua, Qxua, Qxua, Qxua, Qxua, Qxua, Qxua, Qxua, Qxua, Qxua, Qxua, Qxua, Qxua, Qxua, Qxua, Qxua, Qxua, Qxua, Qxua, Qxua, Qxua, Qxua, Qxua, Qxua, Qxua, Qxua, Qxua, Qxua, Qxua, Xue, Xue
Xue, Xue, Xue, Xue, Xue, Xue, Qxua, Qxua, Qxua, Qxua, Qxua, Qxua, Qxua, Qxua, Qxua, Qxua, Qxua, Qxua, Qxua, Qxua, Qxua, Qxua, Qxua, Qxua, Qxua, Qxua, Qxua, Qxua, Qxua, Qxua, Qxua, Qxua, Qxua, Qxua, Qxua, Qxua, Qxua, Qxua, Qxua, Qxua, Qxua, Qxua, Qxua, Xue, Xue
Xue, Xue, Xue, Xue, Xue, Xue, Qxua, Qxua, Qxua, Qxua, Qxua, Qxua, Qxua, Qxua, Qxua, Qxua, Qxua, Qxua, Qxua, Qxua, Qxua, Qxua, Qxua, Qxua, Qxua, Qxua, Qxua, Qxua, Qxua, Qxua, Qxua, Qxua, Qxua, Qxua, Qxua, Qxua, Qxua^Xo, Qxua, Qxua, Qxua, Qxua, Qxua, Qxua, Xue, Xue
Xue, Xue, Xue, Xue, Qxua, Qxua, Qxua, Qxua, Qxua, Qxua, Qxua^Xo, Qxua, Qxua^Xo, Qxua, Qxua^Xo, Qxua, Qxua^Xo, Qxua, Qxua^Xo, Qxua, Qxua^Xo, Qxua, Qxua^Xo, Qxua^Xo, Qxua^Xo, Qxua^Xo, Qxua^Xo, Qxua^Xo, Qxua^Xo, Qxua^Xo, Qxua^Xo, Qxua^Xo, Qxua^Xo, Qxua^Xo, Qxua^Xo, Qxua^Xo, Qxua, Qxua^Xo, Qxua^Xo, Qxua, Qxua, Qxua, Qxua, Xue, Xue
Xue, Xue, Xue, Xue, Qxua, Qxua, Qxua, Qxua, Qxua^Xo, Qxua^Xo, Qxua, Qxua^Xo, Qxua, Qxua^Xo, Qxua, Qxua^Xo, Qxua, Qxua^Xo, Qxua, Qxua^Xo, Qxua, Qxua^Xo, Qxua, Qxua, Qxua, Qxua, Qxua, Qxua, Qxua, Qxua, Qxua, Qxua, Qxua, Qxua, Qxua, Qxua, Qxua, Qxua, Qxua^Xo, Qxua^Xo, Qxua, Qxua, Qxua, Xue, Xue
Xue, Xue, Xue, Xue, Xue, Qxua, Qxua, Qxua, Qxua^Xo, Qxua, Qxua, Qxua, Qxua, Qxua, Qxua, Qxua, Qxua, Qxua, Qxua, Qxua, Qxua, Qxua, Qxua, Qxua, Qxua, Qxua, Qxua, Qxua, Qxua, Qxua, Qxua, Qxua, Qxua, Qxua, Qxua, Qxua, Qxua, Qxua, Qxua, Qxua^Xo, Qxua, Qxua, Qxua, Qxua, Xue
Xue, Xue, Xue, Xue, Xue, Xue, Qxua, Qxua, Qxua^Xo, Qxua, Qxua, Qxua, Qxua, Qxua, Qxua, Qxua, Qxua, Qxua, Qxua, Qxua, Qxua, Qxua, Qxua, Qxua, Qxua, Qxua, Qxua, Qxua, Qxua, Qxua, Qxua, Qxua, Qxua, Qxua, Qxua, Qxua, Qxua, Qxua, Qxua, Qxua^Xo, Qxua^Xo, Qxua, Qxua, Qxua, Xue
Xue, Xue, Xue, Xue, Xue, Xue, Xue, Xue, Xue, Qxua, Xue, Uue, Uue, Qxua, Uue, Qxua, Qxua, Qxua, Qxua, Qxua, Qxua, Qxua, Uue, Qxua, Qxua, Qxua, Qxua, Qxua, Qxua, Xue, Xue, Qxua, Xue, Qxua, Uue, Qxua, Qxua, Qxua, Qxua, Qxua, Xue, Xue, Xue, Xue, Xue
Xue, Xue, Xue, Xue, Xue, Xue, Xue, Xue, Xue, Xue, Xue, Uue, Uue, Uue, Uue, Uue, Uue, Qxua, Uue, Uue, Uue, Uue, Xue, Qxua, Uue, Uue, Uue, Xue, Uue, Uue, Uue, Uue, Uue, Uue, Uue, Qxua, Qxua, Qxua, Qxua, Qxua, Xue, Xue, Xue, Xue, Xue
Xue, Xue, Xue, Xue, Xue, Xue, Xue, Xue, Xue, Xue, Xue, Xue, Uue, Uue, Xue, Uue, Uue, Uue, Uue, Uue, Uue, Xue, Xue, Uue, Uue, Uue, Uue, Uue, Uue, Uue, Uue, Uue, Uue, Uue, Uue, Uue, Uue, Xue, Xue, Xue, Xue, Xue, Xue, Xue, Xue
Xue, Xue, Xue, Xue, Xue, Xue, Xue, Xue, Xue, Xue, Xue, Xue, Uue, Uue, Xue, Xue, Uue, Uue, Xue, Uue, Uue, Uue, Uue, Uue, Uue, Uue, Uue, Uue, Xue, Xue, Xue, Xue, Xue, Uue, Uue, Uue, Uue, Xue, Xue, Xue, Xue, Xue, Xue, Xue, Xue
Xue, Xue, Xue, Xue, Xue, Xue, Xue, Xue, Xue, Xue, Xue, Xue, Uue, Uue, Uue, Uue, Uue, Xue, Uue, Uue, Uue, Uue, Uue, Uue, Uue, Uue, Uue, Xue, Xue, Xue, Xue, Xue, Xue, Xue, Xue, Uue^Ii, Xue, Xue, Xue, Xue, Xue, Xue, Xue, Xue, Xue
Xue, Xue, Xue, Xue, Xue, Xue, Xue, Xue, Xue, Xue, Xue, Uue, Uue, Uue, Uue, Uue, Xue, Uue, Xue, Uue, Xue, Xue, Xue, Xue, Xue, Uue, Xue, Xue, Xue, Xue, Xue, Xue, Uue, Xue, Uue, Xue, Uue, Uue, Uue, Xue, Xue, Xue, Xue, Xue, Xue
Xue, Xue, Xue, Xue, Xue, Xue, Xue, Xue, Xue, Xue, Uue, Uue, Uue, Uue, Xue, Xue, Xue, Xue, Xue, Xue, Xue, Xue, Xue, Xue, Xue, Xue, Xue, Xue, Ai, Uue, Uue, Uue, Uue, Uue, Uue, Uue, Uue, Uue, Uue, Uue, Uue, Uue, Wot, Xue, Xue
Xue, Xue, Xue, Xue, Xue, Xue, Xue, Xue, Xue, Xue, Uue, Uue, Uue, Uue, Xue, Xue, Xue, Xue, Xue, Xue, Xue, Xue, Xue, Xue, Xue, Xue, Xue, Xue, Xue, Xue, Xue, Uue, Uue, Uue, Uue, Uue, Uue, Uue, Uue, Uue, Xue, Xue, Xue, Xue, Xue
Xue, Xue, Xue, Xue, Xue, Xue, Xue, Xue, Xue, Uue, Uue, Uue, Uue, Uue, Xue, Xue, Xue, Xue, Xue, Xue, Xue, Xue, Xue, Xue, Xue, Xue, Xue, Xue, Gg^Fet, Xue, Uue, Uue, Uue, Uue, Uue, Uue, Uue, Uue, Uue, Uue, Uue, Xue, Uue^Ii, Xue, Xue
Xue, Xue, Xue, Xue, Qxe, Xue, Xue, Xue, Uue, Uue, Uue, Uue, Uue, Xue, Xue, Xue, Xue, Xue, Xue, Xue, Xue, Xue, Xue, Xue, Xue, Xue, Xue, Xue, Xue, Uue, Xue, Uue, Uue, Uue, Uue, Uue, Uue, Uue, Uue, Uue, Xue, Uue, Xue, Xue, Xue
Qxe, Qxe, Qxe, Qxe, Qxe, Qxe, Qxe^Xo, Qxe^Xo, Qxe^Xo, Qxe^Xo, Qxe^Xo, Uue, Qxe, Xue, Qxe, Qxe, Qxe, Qxe, Qxe, Xue, Qxe, Qxe, Qxe, Qxe, Qxe, Xue, Xue, Xue, Qxe, Xue, Uue, Uue, Uue, Uue, Uue, Uue, Uue, Uue, Uue, Uue, Uue, Xue, Uue^Ecf, Xue, Xue
Xue, Xue, Xue, Xue, Xue, Qxe^Xo, Xue, Qxe^Xo, Qxe^Xo, Qxe^Xo, Xue, Qxe^Xo, Xue, Qxe, Xue, Xue, Xue, Qxe, Xue, Qxe, Xue, Qxe, Qxe, Qxe, Xue, Xue, Xue, Xue, Xue, Uue, Xue, Uue, Uue, Uue, Uue, Uue, Uue, Uue, Uue, Uue, Xue, Uue, Xue, Xue, Xue
Xue, Xue, Xue, Xue, Uue, Xue, Uue, Uue, Uue, Uue, Uue, Xue, Uue, Xue, Xue, Xue, Xue, Xue, Xue, Xue, Xue, Qxe, Qxe, Qxe, Qxe, Xue, Xue, Xue, Xue, Xue, Xue, Uue, Uue, Uue, Uue, Uue, Uue, Uue, Uue, Uue, Xue, Xue, Xue, Xue, Qxe
Xue, Xue, Xue, Xue, Uue, Uue, Uue, Uue, Wwby^Cov, Uue, Uue, Uue, Uue, Xue, Xue, Xue, Xue, Xue, Xue, Xue, Xue, Xue, Xue, Qxe, Qxe, Qxe, Qxe, Xue, Xue, Xue, Xue, Xue, Xue, Xue, Qxe^Xo, Qxe^Xo, Qxe^Xo, Xue, Xue, Xue, Xue, Xue, Xue, Qxe, Qxe
Xue, Xue, Xue, Urb, Uue, Uue, Uue, Wwby^Cov, Wwby^Kov, Wwby^Cov, Uue, Uue, Uue, Urb, Xue, Xue, Xue, Xue, Xue, Xue, Xue, Xue, Xue, Xue, Xue, Xue, Xue, Qxe, Qxe, Qxe, Qxe, Qxe, Qxe^Xo, Qxe^Xo, Qxe^Xo, Qxe^Xo, Qxe^Xo, Qxe^Xo, Qxe^Xo, Xue, Qxe, Xue, Qxe, Qxe, Qxe
Xue, Xue, Xue, Xue, Uue, Uue, Uue, Wwby^Cov, Wwby^Cov, Wwby^Cov, Uue, Uue, Uue, Xue, Xue, Xue, Xue, Xue, Xue, Xue, Xue, Xue, Xue, Xue, Xue, Xue, Xue, Xue, Xue, Xue, Xue, Xue, Xue, Xue, Uue, Uue, Uue, Xue, Xue, Qxe, Xue, Qxe, Qxe, Qxe, Qxe
Xue, Xue, Xue, Urb, Uue, Uue, Uue, Uue, Uue, Uue, Uue, Uue, Uue, Urb, Xue, Xue, Xue, Xue, Xue, Xue, Xue, Xue, Xue, Xue, Xue, Xue, Xue, Xue, Xue, Xue, Xue, Xue, Xue, Xue, Uue, Uue, Xue, Xue, Xue, Xue, Xue, Xue, Xue, Qxe, Xue
Xue, Xue, Xue, Xue, Uue, Uue, Uue, Uue, Urb, Uue, Xue, Uue, Xue, Xue, Xue, Xue, Xue, Xue, Xue, Xue, Xue, Xue, Xue, Xue, Xue, Xue, Xue, Xue, Xue, Xue, Xue, Xue, Xue, Xue, Xue, Uue, Uue, Xue, Xue, Xue, Xue, Xue, Xue, Xue, Xue
Xue, Xue, Xue, Xue, Xue, Xue, Xue, Xue, Xue, Xue, Xue, Xue, Xue, Xue, Xue, Xue, Xue, Xue, Xue, Xue, Xue, Xue, Xue, Xue, Xue, Xue, Xue, Xue, Xue, Xue, Xue, Xue, Xue, Xue, Uue, Uue, 8 Kay, Uue, Uue, Xue, Xue, Xue, Xue, Xue, Xue
Xue, Xue, Xue, Xue, Xue, Xue, Xue, Xue, Xue, Uue^Ii, Uue, Xue, Xue, Xue, Uue, Uue, Uue, Xue, Uue, Xue, Xue, Xue, Xue, Xue, Xue, Xue, Xue, Xue, Xue, Xue, Xue, Xue, Uue, Uue, Uue, Cay, Cay, Cay, Uue, Xue, Xue, Xue, Xue, Xue, Xue
Xue, Xue, Xue, Xue, Xue, Xue, Xue, Xue, Xue, Uue, Uue, Uue, Uue, Uue, Uue, Uue, Uue, Uue, Uue, Xue, Xue, Xue, Xue, Xue, Xue, Xue, Xue, Xue, Xue, Xue, Xue, Xue, Uue, Uue, Xue, Uue, Uue, Uue, Uue, Xue, Xue, Xue, Xue, Xue, Xue
Xue, Xue, Xue, Xue, Xue, Xue, Xue, Xue, Xue, Xue, Xue, Uue, Xue, Uue, Xue, Uue, Xue, Uue, Uue, Uue, Uue, Xue, Xue, Xue, Xue, Xue, Xue, Xue, Xue, Xue, Xue, Xue, Uue, Uue, Xue, Xue, Xue, Xue, Xue, Xue, Xue, Xue, Xue, Xue, Xue
Xue, Xue, Xue, Xue, Xue, Xue, Xue, Xue, Xue, Xue, Xue, Xue, Xue, Xue, Uue, Xue, Xue, Uue, Uue, Uue, Xue, Xue, Xue, Xue, Xue, Xue, Xue, Xue, Xue, Xue, Xue, Xue, Xue, Xue, Uue, Xue, Xue, Xue, Xue, Xue, Xue, Xue, Xue, Xue, Xue
Xue, Xue, Xue, Xue, Xue, Xue, Xue, Xue, Xue, Xue, Xue, Xue, Xue, Xue, Xue, Uue, Uue, Uue, Uue, Uue, Xue, Xue, Xue, Xue, Xue, Xue, Xue, Xue, Xue, Xue, Xue, Uue, Uue, Uue, Uue, Xue, Xue, Xue, Xue, Xue, Xue, Xue, Xue, Xue, Xue
Xue, Xue, Xue, Xue, Xue, Xue, Xue, Xue, Xue, Xue, Uue, Xue, Uue, Uue, Uue, Uue, Uue, Uue, Xue, Xue, Xue, Xue, Xue, Xue, Qlf, Xue, Xue, Xue, Uue, Xue, Uue, Uue, Uue, Uue, Uue, Uue, Uue, Xue, Uu, Xue, Xue, Xue, Qlf, Xue, Xue
Xue, Xue, Xue, Xue, Xue, Xue, Xue, Xue, Xue, Xue, Uue, Uue, Uue, Uue, Uue, Uue, Uue, Uue, Xue, Xue, Xue, Xue, Qlf^Cov, Qlf, Qlf, Xue, Qlf, Uue, Uue, Uue, Uue, Uue, Uue, Uue, Uue, Uue, Uue, Uue, Uue, Uu, Uu, Xue, Qlf, Xue, Xue
Xue, Xue, Xue, Xue, Xue, Xue, Xue, Uue, Uue, Xue, Uue, Uue, Uue, Uue, Xue, Xue, Xue, Xue, Xue, Xue, Qlf^Cov, 4 Qlf^Kov, Qlf^Cov, Uu, Uue, Qlf, Qlf, Uue, Qlf, Uue, Uue, Uue, Uue, Uue, Uue, Uue, Uue, Uue, Uue, Qlf, Qlf, Uu, Qlf^Cov, Qlf, Qlf
Xue, Xue, Xue, Xue, Xue, Xue, Xue, Uue, Uue, Uue, Uue, Uue, Uue, Uue, Xue, Xue, Xue, Xue, Xue, Xue, Uu, Qlf^Cov, Uu, Uu, Uue, Qlf, Qlf, Qlf, Uue, Uue, Uue, Uue, Cay, Cay, Cay, Uue, Uue, Uue, Uue, Uue, Qlf, Qlf, Qlf, 7 Qlf^Kov, Qlf
Xue, Xue, Xue, Xue, Xue, Xue, Xue, Xue, Uue, Uue, Uue, Uue, Xue, Xue, Xue, Xue, Xue, Xue, Xue, Xue, Xue, Uu, Qlf, Qlf, Qlf, Uue, Uue, Uue, Uue, Uue, Uue, Uue, Cay, Kay, Cay, Uue, Uue, Uue, Uue, Uue, Qlf, Qlf, Qlf^Cov, Qlf^Cov, Qlf
Xue, Xue, Xue, Xue, Xue, Xue, Xue, Uue, Uue, Uue, Uue, Uue, Xue, Xue, Xue, Xue, Xue, Xue, Xue, Xue, Xue, Qlf, Qlf, Qlf, Qlf, Uue, Uue, Uue, Uue, Uue, Uue, Uue, Uue, Cay, Uue, Uue, Uue, Uue, Uue, Qlf, Uue, Uu, Uu, Uu, Qlf
Xue, Xue, Xue, Xue, Xue, Xue, Uue, Uue, Uue, Uue, Uue, Xue, Xue, Xue, Xue, Xue, Xue, Xue, Xue, Xue, Qlf^Cov, Qlf, Qlf, Qlf, Uue, Uue, Qlf, Qlf, Uue, Uue, Uue, Uue, Uue, Uue, Uue, Uue, Uue, Uue, Uue, Uue, Qlf, Qlf, Qlf, Qlf, Qlf
Xue, Xue, Xue, Xue, Xue, Xue, Uue, Uue, Uue, Uue, Uue, Uue, Uue, Xue, Xue, Xue, Xue, Xue, Xue, Xue, 5 Qlf^Kov, Uu, Uu, Qlf, Uue, Qlf, Qlf, Uue, Uue, Uue, Uue, Uue, Uue, Uue, Uue, Uue, Uue, Uue, Uue, Uue, Uue, Uu, Uu, Qlf, Qlf
Xue, Xue, Xue, Xue, Uue, Uue, Uue, Uue, Uue, Uue, Xue, Uue, Xue, Xue, Xue, Xue, Xue, Xue, Xue, Xue, Xue, Qlf^Cov, Uu, Uue, Uue, Qlf, Uue, Uue, Uue, Uue, Uue, Uue, Uue, Uue, Uue, Uue, Uue, Uue, Qlf, Qlf, Qlf, Uue, Uu, Qlf^Cov, Qlf
Xue, Xue, Xue, Xue, Uue, Uue, Uue, Uue, Uue, Xue, Xue, Xue, Xue, Xue, Xue, Xue, Xue, Xue, Xue, Xue, Xue, Qlf^Cov, Qlf^Cov, Uu, Qlf, Qlf, Qlf, Uue, Uue, Uue, Uue, Uue, Uue, Uue, Uue, Uue, Uue, Uue, Uue, Uue, Qlf, Qlf, Qlf^Cov, 6 Qlf^Kov, Qlf
Xue, Xue, Xue, Xue, Uue, Uue, Btym, Uue, Uue, Xue, Xue, Xue, Xue, Xue, Xue, Xue, Xue, Xue, Xue, Xue, Xue, Xue, Qlf, Qlf, Uue, Uue, Uue, Uue, Uue, Uue, Uue, Uue, Xue, Uue, Uue, Uue, Uue, Uue, Uue, Uue, Uu, Uu, Qlf, Qlf^Cov, Qlf
Xue, Xue, Xue, Xue, Xue, Xue, Btym^Bydc, Xue, Xue, Xue, Xue, Xue, Xue, Xue, Xue, Xue, Xue, Xue, Xue, Xue, Xue, Xue, Xue, Qlf, Qlf, Uue, Uue, Uue, Uue, Uue, Xue, Xue, Xue, Xue, Xue, Uue, Uue, Uue, Uue, Uue, Uue, Qlf, Uu, Uu, Qlf
Xue, Xue, Rrc, Rrc^Vypr, Rrc, Xue, Brym, Xue, Rrc, Xue, Xue, Xue, Xue, Xue, Xue, Xue, Xue, Xue, Xue, Xue, Xue, Xue, Xue, Xue, Qlf, Uue, Uue, Uue, Xue, Xue, Xue, Xue, Gs^Fp, Xue, Xue, Xue, Xue, Uue, Uue, Uue, Qlf, Uue, Qlf, Qlf, Xue
Xue, Xue, Rrc, Rrc, Kmy, Brym^Bryb, Brym, Rrc^Bryb, Kmy, Rrc, Xue, Xue, Xue, Xue, Xue, Xue, Xue, Xue, Xue, Xue, Xue, Xue, Xue, Xue, Xue, Uue, Xue, Xue, Xue, Xue, Gs^Fms, Gs^Fp, Gs^Fms, Gs^Fms, Gs^Fp, Xue, Xue, Xue, Xue, Uue, Uue, Qlf, Uue, Qlf, Xue
Xue, Rrc^Vypr, Rrc, Rrc, Brym, Cmy, Cmy, Cmy, Rrc, Rrc, Rrc^Vypr, Xue, Xue, Xue, Xue, Xue, Xue, Xue, Xue, Xue, Xue, Xue, Xue, Xue, Xue, Xue, Xue, Xue, Gs^Fp, Gs^Fp, Gs^Fms, Gs^Fms, Gs^Fp, Gs^Fp, Gs^Fms, Gs^Fms, Gs^Fp, Xue, Xue, Xue, Xue, Uue, Xue, Xue, Xue
Xue, Rrc^Ebn, Rrc, Rrc, Brym, Brym, 1 Brym, Rrc, Rrc, Rrc, Rrc, Xue, Xue, Xue, Xue, Xue, Xue, Xue, Xue, Xue, Xue, Xue, Xue, Xue, Xue, Xue, Xue, Xue, Gs^Fms, Gs^Fms, Gs^Fds, Gs^Fms, Gs^Fms, Gs^Fp, Gs^Fp, Gs^Fms, Gs^Fp, Xue, Xue, Xue, Xue, Xue, Xue, Xue, Xue
Xue, Xue, Rrc^Vypr, Rrc, Rrc, Rrc, Rrc, Brym, Rrc, Rrc, Rrc, Rrc^Ebn, Xue, Xue, Xue, Xue, Xue, Xue, Xue, Xue, Xue, Xue, Xue, Xue, Xue, Xue, Xue, Xue, Gs^Fp, Gs^Fms, Gs^Fms, Gs^Fds, Gg^Fet, Gs^Fds, Gs^Fms, Gs^Fms, Gs^Fms, Xue, Xue, Xue, Xue, Xue, Xue, Xue, Xue
Xue, Xue, Xue, Brym, Brym, Rrc, Rrc, Rrc, Rrc, Rrc, Xue, Xue, Xue, Xue, Xue, Xue, Xue, Xue, Xue, Xue, Xue, Xue, Xue, Xue, Xue, Xue, Xue, Xue, Gs^Fms, Gs^Fp, Gs^Fms, Gs^Fds, Gs^Fds, Gs^Fds, Gs^Fms, Gs^Fp, Gs^Fp, Xue, Xue, Xue, Xue, Xue, Xue, Xue, Xue
Xue, Xue, Xue, Brym^Vymb, Brym, Rrc, Rrc, Rrc, Brym, Rrc^Vypr, Xue, Xue, Xue, Xue, Xue, Xue, Xue, Xue, Xue, Xue, Xue, Xue, Xue, Xue, Xue, Xue, Xue, Xue, Ww^Ii, Gs^Fp, Gs^Fms, Gs^Fms, Gs^Fms, Gs^Fms, Gs^Fp, Gs^Fp, Ww^Ii, Xue, Xue, Xue, Xue, Xue, Xue, Xue, Xue
Xue, Xue, Xue, Brym^Ebn, Brym, Brym, Brym, Brym, Brym, Brym^Ebn, Xue, Xue, Xue, Xue, Xue, Xue, Xue, Xue, Xue, Xue, Xue, Xue, Xue, Xue, Xue, Xue, Xue, Xue, Wo^Xo, Ww^Ii, Gs^Fp, Gs^Fp, Gs^Fp, Gs^Fms, Gs^Fp, Ww^Ii, Wo^Xo, Xue, Xue, Xue, Xue, Xue, Xue, Xue, Xue
Xue, Xue, Xue, Brym^Vymb, Brym, Brym, Brym^Vymb, Brym, Brym, Brym^Vymb, Xue, Xue, Xue, Xue, Xue, Xue, Xue, Xue, Xue, Xue, Xue, Xue, Xue, Xue, Xue, Xue, Xue, Xue, Xue, Ww^Ii, Gs^Fms, Gs^Fms, Ww^Ii, Gs^Fp, Gs^Fp, Ww^Ii, Xue, Xue, Xue, Xue, Xue, Xue, Xue, Xue, Xue
Xue, Xue, Xue, Brym^Ebn, Brym, Brym, Brym, Brym, Brym, Brym^Ebn, Xue, Xue, Xue, Xue, Xue, Xue, Xue, Xue, Xue, Xue, Xue, Xue, Xue, Xue, Xue, Xue, Xue, Xue, Xue, Xue, Xue, Ww^Ii, Wo^Xo, Ww^Ii, Xue, Xue, Xue, Xue, Xue, Xue, Xue, Xue, Xue, Xue, Xue
Xue, Xue, Xue, Brym, Brym, Brym, Brym, Brym, Brym, Brym, Xue, Xue, Xue, Xue, Xue, Xue, Xue, Xue, Xue, Xue, Xue, Xue, Xue, Xue, Xue, Xue, Xue, Xue, Xue, Xue, Xue, Xue, Xue, Xue, Xue, Xue, Xue, Xue, Xue, Xue, Xue, Xue, Xue, Xue, Xue
