border_size=1
usage=map

Xomy, Xomy, Xomy, Xomy, Xomy, Xomy, Xomy, Xomy, Xomy, Xomy, Xomy, Xomy, Kmy, Xomy, Xomy, Xomy, Xomy, Xomy, Xomy, Xomy, Xomy, Xomy, Xomy, Xomy, Xomy, Xomy
Xomy, Xomy, Xomy, Xomy, Xomy, Xomy, Xomy, Xomy, Xomy, Xomy, Kmy, Kmy, 2 Cmy, Kmy, Kmy, Xomy, Xomy, Xomy, Xomy, Xomy, Xomy, Xomy, Xomy, Xomy, Xomy, Xomy
Xomy, Xomy, Xomy, Xomy, Xomy, Xomy, Xomy, Xomy, Kmy, Kmy, Cmy, Cmy, Cmy^Xo, Cmy, Cmy, Kmy, Kmy, Xomy, Xomy, Xomy, Xomy, Xomy, Xomy, Xomy, Xomy, Xomy
Xomy, Xomy, Xomy, Xomy, Xomy, Xomy, Kmy, Kmy, Cmy, Cmy, Cmy^Xo, Cmy^Xo, 7 Rrc, Cmy^Xo, Cmy^Xo, Cmy, Cmy, Kmy, Kmy, Xomy, Xomy, Xomy, Xomy, Xomy, Xomy, Xomy
Xomy, Xomy, Xomy, Xomy, Kmy, Kmy, Cmy, Cmy, Cmy^Xo, Cmy^Xo, Rrc, Rrc, Rrc, Rrc, Rrc, Cmy^Xo, Cmy^Xo, Cmy, Cmy, Kmy, Kmy, Xomy, Xomy, Xomy, Xomy, Xomy
Xomy, Xomy, Kmy, Kmy, Cmy, Cmy, Cmy^Xo, Cmy^Xo, Rrc, Rrc, Rrc, Rrc, Rrc, Rrc, Rrc, Rrc, Rrc, Cmy^Xo, Cmy^Xo, Cmy, Cmy, Kmy, Kmy, Xomy, Xomy, Xomy
Xomy, 1 Kmy, Cmy, Cmy, Cmy^Xo, Cmy^Xo, Rrc, Rrc, Rrc, Rrc, Rrc, Rrc, Rrc, Rrc, Rrc, Rrc, Rrc, Rrc, Rrc, Cmy^Xo, Cmy^Xo, Cmy, Cmy, Kmy, Kmy, Xomy
Xomy, Kmy, Cmy, Cmy^Xo, Rrc, Rrc, Rrc, Rrc, Rrc, Rrc, Rrc, Rrc, Rrc, Rrc, Rrc, Rrc, Rrc, Rrc, Rrc, Rrc, Rrc, Cmy^Xo, Cmy^Xo, Cmy, Kmy, Xomy
Xomy, Kmy, Cmy, Cmy^Xo, Rrc, Rrc, Rrc, Rrc, Rrc, Rrc, Rrc, Rrc, Rrc, Rrc, Rrc, Rrc, Rrc, Rrc, Rrc, Rrc, Rrc, 3 Rrc, Cmy^Xo, Cmy, Kmy, Xomy
Xomy, Kmy, Cmy, Cmy^Xo, Rrc, Rrc, Rrc, Rrc, Rrc, Rrc, Rrc, Rrc, Rrc, Rrc, Rrc, Rrc, Rrc, Rrc, Rrc, Rrc, Rrc, Rrc, Cmy^Xo, Cmy, Kmy, Xomy
Xomy, Kmy, Cmy, Cmy^Xo, Rrc, Rrc, Rrc, Rrc, Rrc, Rrc, Rrc, Rrc, Rrc, Rrc, Rrc, Rrc, Rrc, Rrc, Rrc, Rrc, Rrc, Rrc, Cmy^Xo, Cmy, Kmy, Xomy
Xomy, Kmy, Cmy, Cmy^Xo, Rrc, Rrc, Rrc, Rrc, Rrc, Rrc, Rrc, Rrc, Rrc, Rrc, Rrc, Rrc, Rrc, Rrc, Rrc, Rrc, Rrc, Rrc, Cmy^Xo, Cmy, Kmy, Xomy
Xomy, Kmy, Cmy, Cmy^Xo, Rrc, Rrc, Rrc, Rrc, Rrc, Rrc, Rrc, Rrc, Rrc, Rrc, Rrc, Rrc, Rrc, Rrc, Rrc, Rrc, Rrc, Rrc, Cmy^Xo, Cmy, Kmy, Xomy
Xomy, Kmy, Cmy, Cmy^Xo, Rrc, Rrc, Rrc, Rrc, Rrc, Rrc, Rrc, Rrc, Rrc, Rrc, Rrc, Rrc, Rrc, Rrc, Rrc, Rrc, Rrc, Rrc, Cmy^Xo, Cmy, Kmy, Xomy
Xomy, Kmy, Cmy, Cmy^Xo, Rrc, Rrc, Rrc, Rrc, Rrc, Rrc, Rrc, Rrc, Rrc, Rrc, Rrc, Rrc, Rrc, Rrc, Rrc, Rrc, Rrc, Rrc, Cmy^Xo, Cmy, Kmy, Xomy
Xomy, Kmy, Cmy, Cmy^Xo, Rrc, Rrc, Rrc, Rrc, Rrc, Rrc, Rrc, Rrc, Rrc, Rrc, Rrc, Rrc, Rrc, Rrc, Rrc, Rrc, Rrc, Rrc, Cmy^Xo, Cmy, Kmy, Xomy
Xomy, Kmy, Cmy, Cmy^Xo, Rrc, Rrc, Rrc, Rrc, Rrc, Rrc, Rrc, Rrc, Rrc, Rrc, Rrc, Rrc, Rrc, Rrc, Rrc, Rrc, Rrc, Rrc, Cmy^Xo, Cmy, Kmy, Xomy
Xomy, Kmy, Cmy, Cmy^Xo, Rrc, Rrc, Rrc, Rrc, Rrc, Rrc, Rrc, Rrc, Rrc, Rrc, Rrc, Rrc, Rrc, Rrc, Rrc, Rrc, Rrc, Rrc, Cmy^Xo, Cmy, Kmy, Xomy
Xomy, Kmy, Cmy, Cmy^Xo, 6 Rrc, Rrc, Rrc, Rrc, Rrc, Rrc, Rrc, Rrc, Rrc, Rrc, Rrc, Rrc, Rrc, Rrc, Rrc, Rrc, Rrc, 5 Rrc, Cmy^Xo, Cmy, Kmy, Xomy
Xomy, Kmy, Cmy, Cmy^Xo, Cmy^Xo, Rrc, Rrc, Rrc, Rrc, Rrc, Rrc, Rrc, Rrc, Rrc, Rrc, Rrc, Rrc, Rrc, Rrc, Rrc, Cmy^Xo, Cmy^Xo, Cmy, Cmy, Kmy, Xomy
Xomy, Kmy, Kmy, Cmy, Cmy, Cmy^Xo, Cmy^Xo, Rrc, Rrc, Rrc, Rrc, Rrc, Rrc, Rrc, Rrc, Rrc, Rrc, Rrc, Cmy^Xo, Cmy^Xo, Cmy, Cmy, Kmy, Kmy, Xomy, Xomy
Xomy, Xomy, Xomy, Kmy, Kmy, Cmy, Cmy, Cmy^Xo, Cmy^Xo, Rrc, Rrc, Rrc, Rrc, Rrc, Rrc, Rrc, Cmy^Xo, Cmy^Xo, Cmy, Cmy, Kmy, Kmy, Xomy, Xomy, Xomy, Xomy
Xomy, Xomy, Xomy, Xomy, Xomy, Kmy, Kmy, Cmy, Cmy, Cmy^Xo, Cmy^Xo, Rrc, 4 Rrc, Rrc, Cmy^Xo, Cmy^Xo, Cmy, Cmy, Kmy, Kmy, Xomy, Xomy, Xomy, Xomy, Xomy, Xomy
Xomy, Xomy, Xomy, Xomy, Xomy, Xomy, Xomy, Kmy, Kmy, Cmy, Cmy, Cmy^Xo, Cmy^Xo, Cmy^Xo, Cmy, Cmy, Kmy, Kmy, Xomy, Xomy, Xomy, Xomy, Xomy, Xomy, Xomy, Xomy
Xomy, Xomy, Xomy, Xomy, Xomy, Xomy, Xomy, Xomy, Xomy, Kmy, Kmy, Cmy, Cmy, Cmy, Kmy, Kmy, Xomy, Xomy, Xomy, Xomy, Xomy, Xomy, Xomy, Xomy, Xomy, Xomy
Xomy, Xomy, Xomy, Xomy, Xomy, Xomy, Xomy, Xomy, Xomy, Xomy, Xomy, Kmy, Kmy, Kmy, Xomy, Xomy, Xomy, Xomy, Xomy, Xomy, Xomy, Xomy, Xomy, Xomy, Xomy, Xomy
