Cmy, Cmy, Cmy, Cmy, Cmy, Cmy, Btyb, Cmy, Btyb, Cmy, Btyb, Gg, Gg^Efm, Brym, Btym, Btym, Btym, Btym, Btym, Btym, Btym, Brym, Btym, Brym, Btym, Btym, Btym, Brym, Btym, Brym, Btym, Btym, Btym, Btym, Btym, Brym, Btym
Cmy, Cmy, Btyb, Cmy, Brym, Cmy, Btym, Btyb, Btym, Btyb, Btym, Gg, Gg^Fet, Gg^Em, Gg^Fp, Btym, Btym, Btym, Btyb, Btym, Btym, Btym, Btym, Btym, Btym, Btym, Btym, Btym, Btym, Btym, Btym, Btym, Btym, Btym, Btym, Btym, Btym
Brym, Btyb, Btym, Btyb, Btyb, Btyb, Btym, Btym, Btym, Btym, Btym, Gg^Efm, Gg, Gg^Efm, Gg^Efm, Gg^Efm, Btyb, Btyb, Btym, Btym, Btym, Btym, Btym, Btym, Btym, Btym, Btym, Btym, Btym, Btym, Btym, Btym, Btym, Btym, Btym, Btym, Btym
Brym, Btym, Btym, Btym, Btym, Btym, Btym, Btym, Btym, Btym, Btym, Gs, Btyb, Btyb, Btyb, Btyb, Btym, Btym, Brym, Brym, Brym, Brym^Vymb, Brym, Btym, Btym, Btym, Btym, Btym, Btym, Btym, Btym, Btym, Btym, Btym, Btym, Btym, Btym
Brym, Btym, Btym, Btym, Btym, Btym, Brym, Btym, Brym, Btym, Gg^Xo, Gg, Btym, Btym, Btym, Btym, Brym, Btym, Brym, Brym^Vymb, Brym, Brym, Brym, Brym, Btym, Btym, Btym, Btym, Btym, Btym, Btym, Btym, Btym, Btym, Btym, Btym, Btym
Brym, Btym, Btym, Btym, Btym, Btym, Btyb, Brym, Brym, Cmy, Gg^Xo, Gs, Btym, Brym, Brym, Brym, Brym^Lymp, Brym, Brym^Vymb, Brym, Brym, Brym^Fynt, Brym, Brym^Vymb, Brym, Btym, Brym^Lymp, Btym^Bydc, Brym, Btym, Btym, Btym, Btym, Btym, Btym, Btym, Btym
Brym, Btym, Brym, Btym, Btym^Bydc, Btym, Btym, Btyb, Brym, Cmy, Cmy, Gg^Xo, Btym, Btyb, Btyb, Brym, Brym, Brym, Brym, Brym, Brym^Vymb, Brym, Brym^Vymb, Brym, Brym, Brym, Brym, Brym, Btyb, Btym, Btym, Btym, Btym, Btym, Btym, Btym, Btym
Brym, Brym, Brym, Brym, Brym, Brym, Brym, Btym, Btyb, Brym, Brym, Cmy, Brym, Btym, Btym, Btyb, Btyb, Btyb, Brym, Brym, Brym, Brym, Brym, Brym, Btyb, Btyb, Btyb, Btyb, Btym, Btym, Btym, Btym, Btym, Btym, Btym, Btym, Btym
Wwt, Wwt, Wwt, Brym, Brym^Vymb, Brym, Brym, Btym, Btym, Btyb, Btyb, Brym, Brym, Btym, Btym, Btym, Btym, Btym, Brym, Brym, Brym, Btyb, Btyb, Btyb, Btym, Btym, Btym, Btym, Brym^Vymb, Brym, Brym^Vymb, Btym, Btym, Btym, Btym, Btym, Btym
Wwt, Wwt^Fynt, Wwt, Brym, Brym, Brym, Brym, Brym^Bryb, Brym^Vymb, Btym, Btym, Btyb, Brym, Brym, Brym, Btym, Brym^Bryl, Btym, Brym, Brym, Brym, Btym, Btym, Btym, Brym, Brym, Brym, Brym, Brym, Brym, Brym^Fynt, Brym, Brym, Btym, Btym, Btym, Btym
Brym, Wwt, Brym, Brym, Brym, Brym, Brym, Brym, Brym, Brym^Bryb, Brym, Btym, Brym, Brym, Brym, Brym, Brym, Brym, Brym, Brym, Brym, Btym, Brym, Brym, Brym, Btyb, Btyb, Btyb, Btyb, Brym, Brym, Brym^Vymb, Btyb, Brym, Btym, Btym, Btym
Brym, Btyb, Brym^Bryb, Brym, Brym, Brym^Vymb, Brym, Brym, Brym, Brym, Brym, Brym, Btyb, Brym, Brym, Brym, Re^Asty, Brym, Brym, Brym, Brym, Brym^Bryl, Brym, Brym, Brym, Btym, Btym, Btym, Btym, Btyb, Btyb, Btyb, Btym, Btyb, Btym, Btym, Btym
Btym, Btym, Btyb, Btyb, Btyb, Btyb, Brym^Bryb, Btyb, Brym, Brym, Btyb, Btyb, Btym, Brym, Brym, Brym, Brym, Brym, Brym^Fynt, Brym, Brym, Brym, Brym, Brym, Brym^Vymb, Brym^Lymp, Brym, Brym, Brym^Lymp, Btym, Btym, Btym, Btym, Btym, Btym, Btym, Btym
Btym, Btym, Btym, Btym, Btym, Btym, Btyb, Btym, Btyb, Btyb, Btym, Btym, Brym, Brym, Brym, Brym, Brym, Brym, Brym, Brym, Brym, Brym, Brym, Brym, Brym, Brym, Brym, Brym, Brym, Brym, Brym, Brym^Lymp, Brym, Btym, Btym, Btym, Btym
Brym, Btym, Btym, Btym, Btym, Btym, Btym, Btym, Btym, Btym, Btym, Btyb, Btyb, Brym, Btyb, Brym, Brym^Bryl, Brym, Brym, Brym, Brym, Brym, Brym^Vymb, Brym, Brym, Brym, Brym, Brym^Vymb, Brym, Brym, Brym, Brym, Brym, Brym, Brym, Btym, Btym
Brym, Brym, Brym, Btym, Brym, Btym, Btym, Btym, Btym, Btym, Btym, Btym, Btym, Btyb, Btym, Btyb, Btyb, Btyb, Btyb, Brym, Btyb, Brym, Brym, Brym, Brym, Brym^Vymb, Brym, Brym, Brym, Brym, Brym, Brym^Vymb, Brym, Brym, Brym, Brym, Brym
Brym, Brym, Btyb, Brym, Brym, Wwt^Vyth, Wwt^Vyth, Wwt^Vyth, Brym, Btym, Brym, Btym, Btym, Btym, Btym, Btym, Btym, Btym, Btym, Btyb, Btym, Btyb, Btyb, Brym^Lymp, Btyb, Brym, Brym^Lymp, Brym, Brym, Brym^Vymb, Brym, 1 Brym, Brym, Brym, Gg, Gg^Efm, Gg^Efm
Brym, Brym, Btym, Brym, Brym, Wwt^Vyth, Wwt^Vyth, Wwt^Vyth, Brym, Brym, Brym^Vymb, Brym, Brym, Btym, Brym, Btym, Btym, Btym, Btym, Btym, Btym, Btym, Btym, Btyb, Btym, Btyb, Btyb, Brym, Btyb, Brym, Brym^Lymp, Brym, Brym, Brym, Gg^Efm, Gg^Fet, Gg
Brym, Brym, Brym^Vymb, Brym, Brym, Brym, Brym, Brym, Brym, Brym, Brym, Brym, Brym, Brym, Brym, Brym, Brym, Brym, Brym, Btym, Brym, Btym, Btym, Btym, Btym, Btym, Btym, Btyb, Btym, Btyb, Btyb, Brym, Brym, Brym, Brym, Gg^Efm, Brym
Brym, Brym, Brym, Brym, Btyb, Brym, Brym, Brym, Brym, Brym, Brym, Btyb, Brym, Brym, Brym, Brym, Brym, Brym, Btyb, Brym, Brym, Brym, Brym, Btym, Brym, Btym, Btym, Btym, Btym, Btym, Btym, Btyb, Btyb, Btyb, Btyb, Btyb, Btyb
Brym, Brym, Brym, Brym, Btym, Btyb, Brym, Brym^Vymb, Brym, Brym, Brym, Btym, Brym, Brym, Brym, Brym^Vymb, Brym, Brym, Btym, Brym, Brym, Btyb, Brym, Brym, Brym, Brym, Brym, Btym, Brym, Btym, Btym, Btym, Btym, Btym, Btym, Btym, Btym
Brym, Brym, Brym, Brym, Brym, Btym, Brym, Brym, Brym, Brym, Brym, Brym, Brym, Brym, Brym, Brym, Brym, Brym, Brym, Brym, Brym, Btym, Brym, Brym, Brym, Brym, Brym, Brym, Brym, Brym, Brym, Btym, Btym, Btym, Btym, Btym, Btym
