border_size=1
usage=map

Btym, Brym, Btym, Brym, Btym, Brym, Btym, Brym, Btym, Btym, Btym, Brym, Btym, Brym, Btym, Brym, Btym, Brym, Btym, Btym, Btym, Brym
Brym, Btym, Btym, Btym, Btym, Btym, Btym, Btym, Btym, Btym, Btym, Btym, Btym, Btym, Btym, Btym, Btym, Btym, Btym, Btym, Btym, Btym
Brym, Btym, Btym, Btym, Btym, Btym, Btym, Btym, Re^Asty, Btym, Wwt^Vyth, Wwt^Vyth, Wwt^Vyth, Btym, Re^Asty, Btym, Btym, Btym, Btym, Btym, Btym, Btym
Brym, Btym, Btym, Btym, Btym, Btym, Btym, Wwt, Wwt, Wwt^Vyth, Wwt^Vyth, Wwt^Vyth, Wwt^Vyth, Wwt^Vyth, Wwt, Wwt, Btym, Btym, Btym, Btym, Btym, Btym
Brym, Btym, Btym, Btym, Btym, Btym, Wwt^Oasy, Wwt, Wwt, Wwt, Wwt, Wwt^Vyth, Wwt, Wwt, Wwt, Wwt, Wwt^Oasy, Btym, Btym, Btym, Btym, Btym
Brym, Btym, Btym, Btym, Wwt^Oasy, Wwt^Oasy, Wwt^Oasy, Wwt^Oasy, Brym, Wwt, Brym, Wwt, Brym, Wwt, Brym, Wwt^Oasy, Wwt^Oasy, Wwt^Oasy, Wwt^Oasy, Btym, Btym, Btym
Brym, Btym, Brym, Brym, Wwt^Oasy, Wwt^Fynt, Wwt^Oasy, Brym, Brym^Lymp, Brym, Wwt^Oasy, Wwt^Oasy, Wwt^Oasy, Brym, Brym^Lymp, Brym, Wwt^Oasy, Wwt^Fynt, Wwt^Oasy, Brym, Brym, Btym
Brym, Brym, Brym, Brym, Brym, Wwt^Oasy, Brym, Brym, Brym, Brym, Wwt^Oasy, Wwt^Fynt, Wwt^Oasy, Brym, Brym, Brym, Brym, Wwt^Oasy, Brym, Brym, Btyb, Brym
Brym, Btyb, Brym, Brym, Btyb, Brym, Brym, Brym, Brym, Brym, Brym, Wwt^Oasy, Brym, Brym, Brym, Brym, Btyb, Brym, Brym, Btyb, Btym, Brym
Brym, Btym, Btym^Sy|, Btym, Btym, Brym, Btym, Btyb, Brym, Brym, Brym, Brym, Brym, Btyb, Btym, Brym, Btym, Btym, Btym^Sy|, Btym, Brym, Brym
Brym, Brym, Brym, Brym, Brym, Btym^Sy|, Brym, Btym, Btym^Sy|, Btym, Btym, Brym, Btym, Btym, Brym, Btym^Sy|, Brym, Brym, Brym, Brym, Brym, Brym
Brym, Brym, Btyb, Brym, Brym, Brym, Brym, Brym, Brym, Brym, Brym, Btym^Sy|, Brym, Brym, Brym, Brym, Brym, Brym, Btyb, Btyb, Btyb, Brym
Brym, Btyb, Btym, Btyb, Brym, Brym, Brym^Vymb, Brym, Brym, Brym, Brym, Brym, Brym, Brym, Brym, Brym, Brym, Brym, Btym^Bydc, Btym, Btym^Bydc, Brym
Brym, Btym^Bydc, Brym, Btym^Bydc, Brym, Brym, Brym, Brym, Brym, Brym, Brym, Brym, Brym, Brym, Brym, Brym^Vymb, Brym, Brym, Brym, Brym, Brym, Brym
Brym, Brym, Brym, Brym, Wwt^Oasy, Brym, Brym, Brym, Brym, Brym, Wwt^Oasy, Wwt^Oasy, Ww^Ewf, Brym, Brym, Brym, Brym, Brym, Wwt^Oasy, Brym, Brym, Brym
Brym, Brym, Brym, Wwt^Oasy, Wwt^Fynt, Wwt^Oasy, Wwt^Oasy, Wwt^Lyml, Wwt^Oasy, Wwt^Oasy, Gg^Efm, Gg^Efm, Gg^Efm, Wwt^Oasy, Wwt^Oasy, Wwt^Lyml, Wwt^Oasy, Ww^Ewf, Wwt^Fynt, Wwt^Oasy, Brym, Brym
Brym, Brym, Brym, Wwt^Oasy, Wwt^Oasy, Ww^Ewf, Wwt^Oasy, Brym^Lymp, Wwt^Oasy, Ww^Ewf, Gg^Efm, Gg^Fet, Gg^Efm, Ww^Ewf, Wwt^Oasy, Brym^Lymp, Wwt^Oasy, Wwt^Oasy, Wwt^Oasy, Wwt^Oasy, Brym, Brym
Brym, Brym, Brym, Brym, Brym, Brym, Brym, Wwt^Oasy, Brym, Ww^Ewf, Wwt^Oasy, Gg^Efm, Wwt, Wwt, Brym, Wwt^Oasy, Brym, Brym, Brym, Brym, Brym, Brym
Brym, Brym, Brym^Vymb, Brym, Brym, Brym, Brym, Brym, Brym, Brym, Brym, Ww^Ewf, Brym, Brym, Brym, Brym, Brym, Brym, Brym^Vymb, Brym, Brym, Brym
Brym, Brym, Brym, Brym, Brym, Brym, Brym, Brym, Brym, Brym, Brym^Vymb, Brym, Brym, Brym, Brym, Brym, Brym, Brym, Brym, Brym, Brym, Brym
Btym, Brym, Brym, Brym, Btyb, Brym, Brym, Brym, Brym, Brym, Brym, Brym, Brym, Brym, Brym, Brym, Brym, Brym, Btyb, Brym, Brym, Brym
Brym, Btym, Btym^Sy|, Btym, Btym, Brym, Btym, Btyb, Brym, Brym, Brym^Lymp, Brym, Brym^Lymp, Brym, Brym, Btyb, Btym, Brym, Btym, Btym, Btym^Sy|, Btym
Brym, Brym, Brym, Brym, Brym, Btym^Sy|, Brym, Btym, Btym^Sy|, Btym, Btym, Brym, Btym, Btym, Btym^Sy|, Btym, Brym, Btym^Sy|, Brym, Brym, Brym, Brym
Brym, Brym, Brym, Brym, Brym, Brym, Brym, Brym, Brym, Brym, Brym, Btym^Sy|, Brym, Brym, Brym, Brym, Brym, Brym, Brym, Brym, Brym, Brym
Brym, Brym, Brym, Kmy, Cmy, Brym, Brym, Brym, Brym, Brym, Brym, Brym, Brym, Brym, Brym, Brym, Brym, Brym^Vymb, Cmy, Kmy, Brym, Brym
Brym, Brym, Brym^Vymb, Cmy, Brym, Brym, Brym, Brym, Brym, Brym, Brym, Brym, Brym^Vymb, Brym, Brym, Brym, Brym, Brym, Brym, Cmy, Brym, Brym
Brym, Brym, Brym, Brym, Brym, Brym, Brym, Brym^Vymb, Brym, Brym, Brym, Brym, Brym, Brym, Brym, Brym, Brym, Brym, Btyb, Brym, Btyb, Brym
Brym, Btyb, Btyb, Btyb, Brym, Brym, Brym, Brym, Brym, Brym, Brym, 1 Brym, Brym, Brym, Brym, Brym^Vymb, Brym, Brym, Btym, Btyb, Btym, Brym
Brym, Btym, Btym, Btym, Brym, Brym, Brym, Brym, Brym, Brym^Vymb, Brym, Brym, Brym, Brym, Brym, Brym, Brym, Brym, Btym, Btym, Btym, Brym
Brym, Btym, Btym, Btym, Brym, Brym, Brym^Vymb, Brym, Brym, Brym, Brym, Brym, Brym^Vymb, Brym, Brym, Brym, Brym, Brym, Btym, Btym, Btym, Brym
Brym, Btym, Btym, Btym, Brym, Brym, Brym, Brym, Brym, Brym, Brym, Brym, Brym, Brym, Brym, Brym, Brym, Brym, Btym, Btym, Btym, Brym
Brym, Btym, Btym, Btym, Brym, Brym, Brym, Brym, Brym, Brym, Brym, Brym, Brym, Brym, Brym, Brym, Brym, Brym, Brym, Btym, Brym, Brym
