border_size=1
usage=map

Btym, Btym, Btym, Btym, Btym, Btym, Btym, Btym, Btym, Btym, Btym, Btym, Btym, Btym, Btym, Btym, Btym, Btym, Btym, Btym, Btym, Btym, Btym, Btym, Btym, Btym, Btym, Btym, Btym
Btym, Btym, Btym, Btym, Btym, Btym, Btym, Btym, Btym, Btym, Btym, Btym, Btym, Btym, Btym, Btym, Btym, Btym, Btym, Btym, Btym, Btym, Btym, Btym, Btym, Btym, Btym, Btym, Btym
Btym, Btym, Btym, Btym, Btym, Btym, Btym, Btym, Btym, Btym, Btym, Btym, Btym, Btym, Cmy, Btym, Btym, Btym, Btym, Btym, Btym, Btym, Btym, Btym, Btym, Btym, Btym, Btym, Btym
Btym, Btym, Btym, Btym, Btym, Btym, Btym, Btym, Cmy, Btym, Cmy, Cmy, Cmy, Cmy, Brym^Ii, Cmy, Cmy, Cmy, Cmy, Btym, Cmy, Btym, Btym, Btym, Btym, Btym, Btym, Btym, Btym
Btym, Btym, Btym, Btym, Btym, Btym, Cmy, Cmy, Brym, Cmy, Brym, Brym, Brym, Brym^Ii, Brym^Ii, Brym^Ii, Brym, Brym, Brym, Cmy, Brym, Cmy, Cmy, Btym, Btym, Btym, Btym, Btym, Btym
Btym, Btym, Btym, Btym, Cmy, Cmy, Brym, Brym, Brym, Brym, Brym, Brym, Brym, Brym, Brym, Brym, Brym, Brym, Brym, Brym, Brym, Brym, Brym, Cmy, Cmy, Btym, Btym, Btym, Btym
Btym, Btym, Cmy, Cmy, Brym, Brym, Brym, Brym, Brym, Brym, Brym, Brym, Brym, Brym, Brym, Brym, Brym, Brym, Brym, Brym, Brym, Brym, Brym, Brym, Brym, Cmy, Cmy, Btym, Btym
Cmy, Cmy, Brym^Ii, Brym, Brym, Brym, Brym, Brym, Brym, Brym, Brym, Brym, Brym, Brym, Brym, Brym, Brym, Brym, Brym, Brym, Brym, Brym, Brym, Brym, Brym, Brym, Brym^Ii, Cmy, Cmy
Cmy, Brym^Ii, Brym^Ii, Brym, Brym, Brym, Brym, Brym, Brym^Ii, Brym^Ii, Brym^Ii, Brym, Brym, Brym, Brym, Brym, Brym, Brym, Brym^Ii, Brym^Ii, Brym^Ii, Brym, Brym, Brym, Brym, Brym, Brym^Ii, Brym^Ii, Cmy
Cmy, Brym^Ii, Brym, Brym, Brym, Brym, Brym, Brym, Brym^Ii, Brym^Ii, Brym^Ii, Brym, Brym, Brym, Brym, Brym, Brym, Brym, Brym^Ii, Brym^Ii, Brym^Ii, Brym, Brym, Brym, Brym, Brym, Brym, Brym^Ii, Cmy
Cmy, Brym, Brym, Brym, Brym, Brym, Brym, Brym, Brym, Brym^Ii, Brym, Brym, Brym, Brym, Brym, Brym, Brym, Brym, Brym, Brym^Ii, Brym, Brym, Brym, Brym, Brym, Brym, Brym, Brym, Cmy
Cmy, Brym, Brym, Brym, Brym, Brym, Brym, Brym, Brym, Brym, Brym, Brym, Brym, Brym, Brym, Brym, Brym, Brym, Brym, Brym, Brym, Brym, Brym, Brym, Brym, Brym, Brym, Brym, Cmy
Cmy, Brym, Brym, Brym, Brym, Brym, Brym, Brym, Brym, Brym, Brym, Brym, Brym^Ii, Brym, Brym, Brym, Brym^Ii, Brym, Brym, Brym, Brym, Brym, Brym, Brym, Brym, Brym, Brym, Brym, Cmy
Cmy, Brym, Brym, Brym, Brym, Brym, Brym, Brym, Brym, Brym, Brym^Ii, Brym, Brym, Brym^Ii, Brym, Brym^Ii, Brym, Brym, Brym^Ii, Brym, Brym, Brym, Brym, Brym, Brym, Brym, Brym, Brym, Cmy
Cmy, Brym, Brym, Brym, Brym, Brym, Brym, Brym, Brym, Brym, Brym, Brym^Ii, Brym, Brym, Re^Asty, Brym, Brym, Brym^Ii, Brym, Brym, Brym, Brym, Brym, Brym, Brym, Brym, Brym, Brym, Cmy
Cmy, Brym, Brym, Brym, Brym, Brym, Brym, Brym, Brym, Brym, Brym, Brym, Brym^Ii, Brym^Ii, Brym^Ii, Brym^Ii, Brym^Ii, Brym, Brym, Brym, Brym, Brym, Brym, Brym, Brym, Brym, Brym, Brym, Cmy
Cmy, Brym, Brym, Brym, Brym, Brym, Brym, Brym, Brym, Brym, Brym, Brym, Brym, Brym^Ii, Brym^Ii, Brym^Ii, Brym, Brym, Brym, Brym, Brym, Brym, Brym, Brym, Brym, Brym, Brym, Brym, Cmy
Cmy, Brym, Brym, Brym, Brym, Brym, Brym, Brym, Brym, Brym, Brym, Brym, Brym, Brym, Brym, Brym, Brym, Brym, Brym, Brym, Brym, Brym, Brym, Brym, Brym, Brym, Brym, Brym, Cmy
Cmy, Brym, Brym, Brym, Brym, Brym, Brym, Brym, Brym^Ii, Brym^Ii, Brym^Ii, Brym, Brym, Brym, Brym, Brym, Brym, Brym, Brym^Ii, Brym^Ii, Brym^Ii, Brym, Brym, Brym, Brym, Brym, Brym, Brym, Cmy
Cmy, Brym, Brym, Brym, Brym, Brym, Brym, Brym, Brym^Ii, Brym^Ii, Brym^Ii, Brym, Brym, Brym, Brym, Brym, Brym, Brym, Brym^Ii, Brym^Ii, Brym^Ii, Brym, Brym, Brym, Brym, Brym, Brym, Brym, Cmy
Cmy, Brym^Ii, Brym^Ii, Brym, Brym, Brym, Brym, Brym, Brym, Brym^Ii, Brym, Brym, Brym, Brym, Brym, Brym, Brym, Brym, Brym, Brym^Ii, Brym, Brym, Brym, Brym, Brym, Brym, Brym^Ii, Brym^Ii, Cmy
Btym, Brym^Ii, Brym^Ii, Brym, Brym, Brym, Brym, Brym, Brym, Brym, Brym, Brym, Brym, Brym, Brym, Brym, Brym, Brym, Brym, Brym, Brym, Brym, Brym, Brym, Brym, Brym, Brym^Ii, Brym^Ii, Brym
Brym, Btyb, Btyb, Brym, Brym, Brym, Brym, Brym, Brym, Brym, Brym, Brym, Brym, Brym, 1 Brym, Brym, Brym, Brym, Brym, Brym, Brym, Brym, Brym, Brym, Brym, Brym, Btyb, Btyb, Btyb
Brym, Btym, Btym, Btyb, Btyb, Btyb, Btyb, Brym, Brym, Brym, Brym, Brym, Brym, Brym, Brym, Brym, Brym, Brym, Brym, Brym, Brym, Brym, Brym, Btyb, Btyb, Btyb, Btym, Btym, Btym
Brym, Btym, Btym, Btym, Btym, Btym, Btym, Btyb, Btyb, Btyb, Brym, Brym, Brym, Brym, Brym, Brym, Brym, Brym, Brym, Btyb, Btyb, Btyb, Btyb, Btym, Btym, Btym, Btym, Btym, Btym
Brym, Btym, Btym, Btym, Btym, Btym, Btym, Btym, Btym, Btym, Btyb, Btyb, Btyb, Brym, Brym, Brym, Btyb, Btyb, Btyb, Btym, Btym, Btym, Btym, Btym, Btym, Btym, Btym, Btym, Btym
Brym, Btym, Btym, Btym, Btym, Btym, Btym, Btym, Btym, Btym, Btym, Btym, Btym, Btyb, Btyb, Btyb, Btym, Btym, Btym, Btym, Btym, Btym, Btym, Btym, Btym, Btym, Btym, Btym, Btym
Brym, Btym, Btym, Btym, Btym, Btym, Btym, Btym, Btym, Btym, Btym, Btym, Btym, Btym, Btym, Btym, Btym, Btym, Btym, Btym, Btym, Btym, Btym, Btym, Btym, Btym, Btym, Btym, Btym
Brym, Btym, Btym, Btym, Btym, Btym, Btym, Btym, Btym, Btym, Btym, Btym, Btym, Btym, Btym, Btym, Btym, Btym, Btym, Btym, Btym, Btym, Btym, Btym, Btym, Btym, Btym, Btym, Btym
