Brym, Btym, Btym, Brym, Btym, Btym, Btym, Btym, Btym, Btym, Btym, Btym, Btym, Btym, Brym, Btyb, Brym, Brym, Wwt^Oasy, Brym, Brym, Btyb, Brym, Btym, Btym, Btym, Btym, Btym, Btym, Btym, Btym, Btym, Btym, Btym, Btym, Btym, Brym
Brym, Btym, Btym, Btym, Btym, Btym, Btym, Btym, Brym, Brym, Brym, Brym, Brym, Brym, Brym, Btym, Wwt^Oasy, Wwt^Oasy, Wwt^Oasy, Wwt^Oasy, Wwt^Oasy, Btym, Brym, Brym, Brym, Brym, Brym, Brym, Brym, Btym, Btym, Btym, Btym, Btym, Btym, Btym, Brym
Brym, Btym, Btym, Btym, Btym, Btym, Brym, Brym^Vymb, Brym, Brym, Brym, Brym, Brym, Btyb, Brym, Wwt^Oasy, Wwt^Oasy, Wwt^Oasy, Wwt^Oasy, Wwt^Oasy, Wwt^Oasy, Wwt^Oasy, Brym, Btyb, Brym, Brym, Brym, Brym^Vymb, Brym, Brym, Brym, Btym, Btym, Btym, Btym, Btym, Brym
Brym, Btym, Btym, Btym, Btym, Btym, Brym, Brym, Brym, Brym, Brym, Brym, Brym, Btym, Brym, Wwt^Oasy, Wwt^Oasy, Wwt^Oasy, Wwt^Fynt, Wwt^Oasy, Wwt^Oasy, Wwt^Oasy, Brym, Btym, Brym, Brym, Brym, Brym, Brym, Brym, Brym, Btym, Btym, Btym, Btym, Btym, Brym
Brym, Btym, Btym, Btym, Btym, Brym, Brym, Brym, Brym, Brym, Brym, Brym, Brym, Btym, Brym, Wwt^Oasy, Wwt^Oasy, Wwt^Oasy, Wwt^Oasy, Wwt^Oasy, Wwt^Oasy, Wwt^Oasy, Brym, Btym, Brym, Brym, Brym, Brym, Brym, Brym, Brym, Brym, Btym, Btym, Btym, Btym, Brym
Brym, Btym, Btym, Btym, Btym, Brym, Brym, Brym, Brym^Vymb, Brym, Brym, Brym, Brym, Brym, Brym, Btyb, Wwt^Oasy, Wwt^Vyth, Wwt^Oasy, Wwt^Oasy, Wwt^Oasy, Btyb, Brym, Brym, Brym, Brym, Brym^Vymb, Brym, Brym, Brym, Brym, Brym, Brym, Btym, Btym, Btym, Brym
Brym, Btym, Btym, Btym, Brym, Brym, Brym, Brym, Brym, Brym, Brym, Brym, Brym, Brym, Brym, Btym, Brym, Wwt^Oasy, Wwt^Oasy, Wwt^Oasy, Brym, Btym, Brym, Brym, Brym, Brym, Brym, Brym, Brym, Brym, Brym, Brym, Brym, Btym, Btym, Btym, Brym
Brym, Btym, Btym, Brym, Brym, Brym, Brym, Brym, Brym, Brym, Brym, Brym, Brym^Vymb, Brym, Brym, Brym, Brym, Brym, Btyb, Brym, Brym, Brym, Brym, Brym, Brym, Brym, Brym, Brym, Brym, Brym, Brym, Brym, Brym, Brym, Btym, Btym, Brym
Brym, Btym, Brym, Brym, Brym, Brym, Brym, Brym, Cmy, Brym, Brym, Brym, Brym, Brym, Brym, Brym, Brym, Btyb, Btym, Btyb, Brym, Brym, Brym, Brym^Vymb, Brym, Brym, Brym, Brym, Cmy, Brym, Brym, Brym, Brym, Brym, Brym, Btym, Brym
Brym, Btym, Brym, Brym, Brym, Brym, Brym, Cmy, 1 Kmy, Cmy, Brym, Brym, Brym, Brym, Brym, Brym, Brym, Btym, Btym^Bydc, Btym, Brym, Brym, Brym, Brym, Brym, Brym, Brym, Cmy, 5 Kmy, Cmy, Brym, Brym, Brym, Brym, Brym, Btym, Brym
Brym, Brym, Brym, Brym, Btyb, Brym, Brym, Cmy, Cmy, Cmy, Brym, Brym, Brym, Brym, Brym, Brym, Brym, Brym, Brym, Brym^Bryb, Brym, Brym, Brym, Brym, Brym, Brym, Brym, Cmy, Cmy, Cmy, Brym, Brym, Btyb, Brym, Brym, Brym, Brym
Brym, Brym, Brym^Vymb, Brym, Btym, Btyb, Brym, Brym, Brym, Brym, Brym, Brym, Brym^Vymb, Brym, Brym, Brym, Brym, Brym, Brym, Brym, Brym, Brym, Brym, Brym, Brym, Brym, Brym, Brym, Brym, Brym, Brym, Btyb, Btym, Brym, Brym, Brym, Brym
Brym, Brym, Brym, Brym, Brym, Btym, Brym, Brym, Brym, Brym, Brym, Brym, Brym, Brym, Brym, Brym, Brym, Brym, Brym, Brym, Brym, Brym, Brym, Brym^Vymb, Brym, Brym, Brym, Brym, Brym, Brym, Brym, Btym, Brym^Vymb, Brym, Brym, Brym, Brym
Brym, Brym, Brym, Brym, Brym, Brym, Brym, Brym, Brym, Brym, Brym, Brym, Brym, Brym, Btyb, Brym, Brym, Brym, Brym^Vymb, Brym, Brym, Brym, Btyb, Brym, Brym, Brym, Brym, Brym, Brym, Brym, Brym, Brym, Brym, Brym, Brym, Brym, Brym
Brym, Brym, Brym, Brym, Brym, Brym, Brym, Brym^Vymb, Brym, Brym, Brym, Brym, Brym, Brym, Btym, Brym, Brym, Brym, Brym, Brym, Brym, Brym, Btym, Brym, Brym, Brym, Brym, Brym, Brym, Brym, Brym, Brym, Brym, Brym, Brym, Brym, Brym
Brym, Brym, Brym, Brym, Brym, Brym, Brym, Brym, Brym, Brym, Brym, Brym, Brym, Brym, Brym, Brym, Brym, Brym, Brym, Brym, Brym, Brym, Brym, Brym, Brym, Brym, Brym, Brym, Brym, Brym, Brym, Brym, Brym, Brym, Brym, Brym, Brym
Brym, Btym, Btym, Btym, Btym, Btym, Btym, Btym, Btym, Brym, Btym, Brym, Brym, Brym, Brym, Brym, Brym, Brym, Brym, Brym, Brym, Brym, Brym, Brym, Brym, Brym, Btym, Brym, Btym, Btym, Btym, Btym, Btym, Btym, Btym, Btym, Brym
Brym, Btym, Btym, Btym, Btym, Btym, Btym, Btym, Btym, Btym^Sy|, Btym, Btym, Btym, Brym, Btym, Brym, Btym, Brym, Brym, Brym, Btym, Brym, Btym, Brym, Btym, Btym, Btym, Btym^Sy|, Btym, Btym, Btym, Btym, Btym, Btym, Btym, Btym, Brym
Xomy, Brym, Brym, Brym, Brym, Brym, Brym, Brym, Brym, Btym^Sy|, Brym, Btym, Btym, Btym, Btym, Btym, Btym, Btym, Btym^Sy|, Btym, Btym, Btym, Btym, Btym, Btym, Btym, Brym, Btym^Sy|, Brym, Brym, Brym, Brym, Brym, Brym, Brym, Brym, Brym
Xomy, Xomy, Xomy, Brym^Bryb, Brym, Brym^Vymb, Brym, Brym, Brym, Brym, Brym, Brym, Brym, Btym, Brym, Btym, Brym, Btym, Btym^Sy|, Btym, Brym, Btym, Brym, Btym, Brym, Brym, Brym, Brym, Brym, Brym, Brym, Brym, Brym, Brym, Btyb, Brym, Brym
Xomy, Xomy, Xomy, Brym, Brym, Brym, Brym, Btyb, Brym^Bryb, Btyb, Brym, Brym, Brym, Brym, Brym, Brym, Brym, Brym, Brym, Brym, Brym, Brym, Brym^Vymb, Brym, Brym, Brym, Btyb, Brym, Brym, Brym^Vymb, Brym, Brym^Lymp, Brym, Btyb, Btym, Btyb, Brym
Xomy, Xomy, Xomy, Brym, Brym, Brym, Brym, Btym, Rrc, Btym, Brym, Brym, Brym, Brym, Kmy, Cmy, Brym, Brym, Brym, Brym, Brym, Brym, Brym, Brym, Brym, Brym, Btym, Brym, Brym, Brym, Brym, Brym, Brym, Btym, Btym^Bydc, Btym, Brym
Brym, Xomy, Brym, Brym^Bryb, Brym, Brym, Btyb, Btym, Btym^Sy|, Btym, Brym, Brym, Brym, Cmy, Cmy, Cmy, Brym, Brym, Brym, Brym, Brym, Brym, Brym, Brym, Brym, Brym, Brym, Brym, Brym, Brym, Btyb, Brym^Lymp, Brym, Brym, Brym, Brym, Brym
Brym, Brym, Brym, Brym, Brym, Brym, Btym, Brym, Brym, Brym, Brym, Brym, Brym, Brym, Brym, Brym, Brym, Brym, Brym, Brym, Brym^Vymb, Brym, Brym, Brym, Brym, Brym, Brym, Brym^Vymb, Brym, Brym, Btym, Brym, Brym, Brym, Brym^Lymp, Brym, Brym
Brym, Brym, Brym, Brym, Brym, Brym, Btym, Brym, Brym, Brym, Brym, Brym, Brym, Btyb, Brym, Brym, Brym, Brym, Brym, Brym, Brym, Brym, Brym, Btyb, Brym, Brym, Brym, Brym, Brym, Brym, Btym, Brym, Brym, Brym, Brym, Brym, Brym
Brym, Btym, Btym, Btym, Btym, Btym, Btym, Btym, Btym, Brym, Btym, Brym, Brym, Btym, Brym, Brym, Brym, Brym, Brym, Brym, Brym, Brym, Brym, Btym, Brym, Brym, Btym, Brym, Btym, Btym, Btym, Btym, Btym, Btym, Btym, Btym, Brym
Brym, Btym, Btym, Btym, Btym, Btym, Btym, Btym, Btym, Btym^Sy|, Btym, Btym, Btym, Btym, Btym, Brym, Btym, Brym, Brym, Brym, Btym, Brym, Btym, Btym, Btym, Btym, Btym, Btym^Sy|, Btym, Btym, Btym, Btym, Btym, Btym, Btym, Btym, Brym
Brym, Brym, Brym, Brym, Brym, Brym, Brym, Brym, Brym, Btym^Sy|, Brym, Btym, Btym, Btym, Btym, Btym, Btym, Btym, Btym^Sy|, Btym, Btym, Btym, Btym, Btym, Btym, Btym, Brym, Btym^Sy|, Brym, Brym^Vymb, Brym, Brym, Brym^Lymp, Brym, Brym, Brym, Brym
Brym, Brym^Vymb, Brym, Brym, Cmy, Brym, Brym, Brym, Brym, Brym, Brym, Brym, Brym, Btym, Brym, Btym, Brym, Btym, Btym^Sy|, Btym, Brym, Btym, Brym, Btym, Brym, Brym, Brym, Brym, Brym, Brym, Brym, Brym, Qxu, Brym, Btyb, Brym, Brym
Brym, Brym, Brym, Brym, Cmy, 4 Kmy, Cmy, Brym, Brym, Brym, Brym, Brym, Btyb, Brym^Bryb, Btyb, Brym, Brym, Brym, Brym, Brym, Brym, Brym, Brym, Brym, Brym, Brym, Brym, Brym, Brym, Brym, Brym, Qxu, Qxu, Qxu, Btym, Brym, Brym
Brym, Btyb, Brym, Brym, Brym, Cmy, Brym, Brym, Brym, Brym, Brym, Brym, Btym, Rrc, Btym, Brym, Brym, Brym, Brym, Brym, Brym, Brym, Brym, Brym, Brym, Brym^Vymb, Brym, Brym, Brym, Brym, Brym, Brym^Lymp, Brym, Brym, Brym, Btyb, Brym
Brym, Btym, Brym, Brym, Brym, Brym, Brym, Brym, Brym, Btyb, Brym, Brym, Btym, Btym^Sy|, Btym, Brym, Brym, Brym, Brym^Vymb, Brym, Brym, Brym, Brym^Fynt, Brym, Brym, Brym, Brym, Btyb, Brym, Brym, Brym, Brym, Brym, Btyb, Brym, Btym, Brym
Brym, Btym, Brym, Brym, Brym, Brym^Vymb, Brym, Brym, Brym, Btym, Brym, Brym, Btym, Btym^Sy|, Btym, Brym, Brym, Brym, Brym, Brym, Brym, Brym, Brym, Brym, Brym, Brym, Brym, Btym, Brym, Brym^Vymb, Brym, Brym, Brym, Btym, Brym, Btym, Brym
Brym, Btym, Brym, Brym, Brym, Brym, Brym, Brym, Brym, Btym, Brym, Brym, Brym, Brym, Brym, Brym, Brym, Brym, Brym, Brym, Brym, Brym, Brym^Vymb, Brym, Brym, Brym, Brym, Btym, Brym, Brym, Brym, Brym, Brym, Brym, Brym, Btym, Brym
Brym, Btym, Btym, Btym, Btym, Btym, Btym, Btym, Btym, Btym, Btym, Brym, Brym, Brym, Brym, Brym, Brym^Bryb, Brym, Brym, Brym, Brym^Bryb, Brym, Brym, Brym, Brym, Brym, Btym, Btym, Btym, Btym, Btym, Btym, Btym, Btym, Btym, Btym, Brym
Mybd, Btym, Btym, Btym, Btym, Btym, Btym, Btym, Btym, Btym, Btym, Btym, Btym, Brym, Btym, Brym, Btym, Brym^Cov, Brym^Cov, Brym^Cov, Btym, Brym, Btym, Brym, Btym, Btym, Btym, Btym, Btym, Btym, Btym, Btym, Btym, Btym, Btym, Btym, Mybd
Mybd, Mybd, Mybd, Mybd, Urfz, Myb, Myb, Mybd, Mybd, Btym, Myb, Btym, Btym, Btym, Btym, Btym, Btym, Btym^Sy|, Btym^Sy|, Btym^Sy|, Btym, Btym, Btym, Btym, Btym, Btym, Mybd, Btym, Mybd, Mybd, Myb, Myb, Myb, Mybd^Eyt, Fyp, Mybd, Mybd
Fypd, Mybd, Myb^Eyt, Myb, Urfz, Myb^Pyg, Mybd, Mybd, Myb^Vypr, Myb, Myb, Mybd^Fyod, Mybd^Fyod, Btym, Mybd, Btym, Mybd, Btym^Sy|, Btym^Sy|, Btym^Sy|, Mybd, Btym, Mybd, Btym, Mybd, Mybd, Urfz, Urfz, Urfz, Myb, Urfz, Myb, Myb, Fyp, Myb^Eyt, Fyp, Mybd
Fyp, Fyp, Fyp, Myb, Mybd^Ayb, Urfz, Mybd, Mybd, Myb, Myb, Myb, Myb^Fyod, Myb^Fyod, Mybd, Mybd, Mybd, Urfz, Mybd, Mybd, Mybd, Mybd, Mybd, Mybd^Vypr, Mybd, Fypd, Fypd, Brym^Fypp, Fypd, Fyp, Urfz, Mybd, Myb^Eyt, Fyp, Fyp^Eyt, Mybd^Eyt, Fypd^Eyt, Fypd
Mybd^Eyt, Fyp^Eyt, Mybd^Eyt, Mybd, Myb^Vypr, Myb, Myb^Pyg, Mybd, Mybd, Myb, Myb, Myb, Myb, Myb, Urfz, Urfz, Mybd, Mybd, Qxu^Fyb\, Qxu, Qxu, Mybd, Mybd, Fyp, Fypd, Brym^Fypp, Brym^Fypp, Fypd, Fypd, Mybd, Mybd^Vypr, Mybd, Fyp, Fyp, Fypd, Fypd, Brym
Fyp, Fypd^Eyt, Fypd^Eyt, Mybd, Mybd, Myb, Mybd, Mybd, Mybd, Urfz, Urfz, Urfz, Urfz, Myb, Urfz, Urfz, Mybd, Qxu, Qxu, Qxu^Fyb\, Qxu^Fyb\, Fyp, Fyp, Fypd, Fyp, Brym^Fypp, Brym^Fypp, Fypd, Fyp, Fyp, Mybd, Mybd, Mybd, Fyp, Fypd, Mybd^Eyt, Mybd
Fyp, Fyp, Fyp, Mybd, Wwby^Cov, Wwby^Cov, Wwby^Cov, Mybd^Pyg, Myb, Mybd, Mybd, Mybd, Mybd, Urfz, Mybd, Myb, Mybd, Qxu, Qxu, Qxu, Qxu^Fyb/, Fyp, Myb, Fypd, Myb, Fyp, Fyp, Fyp, Mybd, Mybd, Wwby^Cov, Wwby^Cov, Wwby^Cov, Mybd, Mybd, Mybd, Mybd
Mybd, Fyp^Eyt, Mybd, Mybd, Wwby^Cov, 2 Woby^Kov, Wwby^Cov, Myb, Mybd, Myb, Mybd, Mybd, Mybd^Pyg, Mybd^Pyg, Mybd, Mybd, Mybd, Qxu, Qxu^Fyb/, Qxu^Fyb/, Qxu, Qxu, Myb, Myb, Myb, Myb, Urfz, Fyp, Fyp, Mybd, Wwby^Cov, 3 Woby^Kov, Wwby^Cov, Mybd, Mybd^Pyg, Mybd^Ayb, Mybd
Mybd, Mybd, Mybd^Pyg, Mybd, Mybd, Wwby^Cov, Mybd, Mybd, Fyp, Fyp, Brym^Fypp, Fyp, Fyp, Mybd^Pyg, Urfz, Urfz, Mybd, Mybd, Qxu, Qxu, Qxu, Qxu, Myb, Myb, Myb^Vypr, Myb, Myb, Urfz, Urfz, Urfz, Mybd, Wwby^Cov, Mybd, Mybd, Myb^Vypr, Myb, Mybd
Myb, Myb, Myb^Ayb, Myb, Myb^Pyg, Urfz, Urfz, Mybd, Fyp, Fypd, Brym^Fypp, Brym^Fypp, Fypd, Mybd, Mybd, Mybd^Pyg, Mybd, Mybd, Mybd, Qxu, Mybd, Mybd, Mybd, Myb, Myb^Pyg, Myb, Myb^Pyg, Myb, Myb, Mybd, Mybd, Mybd, Urfz, Myb, Myb, Myb, Myb
Myb, Myb, Myb, Myb, Myb^Vypr, Myb, Myb^Pyg, Myb, Mybd, Fyp, Fypd, Brym^Fypp, Fypd, Mybd, Mybd, Mybd, Mybd, Mybd^Vypr, Urfz, Mybd, Urfz, Mybd, Mybd, Mybd^Pyg, Mybd^Pyg, Myb^Pyg, Myb^Pyg, Myb, Myb, Mybd, Mybd, Mybd^Pyg, Urfz, Urfz^Ayb, Urfz, Myb^Pyg, Myb
Myb, Myb, Myb, Myb, Myb, Myb, Myb, Myb, Myb, Fyp, Fypd, Fyp, Brym, Fypd, Brym, Mybd, Mybd, Mybd, Mybd, Urfz, Mybd, Urfz, Brym, Mybd^Pyg, Brym^Pyg, Myb^Pyg, Myb, Myb, Myb, Mybd, Mybd, Myb, Myb, Urfz, Myb, Myb, Brym
