border_size=1
usage=map

Xomy, Xomy, Xomy, Xomy, Xomy, Xomy, Xomy, Xomy, Xomy, Xomy, Xomy, Xomy, Xomy, Xomy, Xomy
Xomy, Xomy, Xomy, Xomy, Xomy, Xomy, Xomy, Xomy, Xomy, Xomy, Xomy, Xomy, Xomy, Xomy, Xomy
Xomy, Xomy, Xomy, Xomy, Xomy, Xomy, Brym, Brym, Brym, Xomy, Xomy, Xomy, Xomy, Xomy, Xomy
Xomy, Xomy, Xomy, Xomy, Brym, Brym, Brym, Brym, Brym, Brym, Brym, Xomy, Xomy, Xomy, Xomy
Xomy, Xomy, Brym, Brym, Brym, Brym, Brym, Brym, Brym, Brym, Brym, Brym, Brym, Xomy, Xomy
Xomy, Xomy, Brym, Brym, Brym, Brym, Brym, Brym, Brym, Brym, Brym, Brym, Brym, Xomy, Xomy
Xomy, Xomy, Brym, Brym, Brym, Brym, Brym, Brym, Brym, Brym, Brym, Brym, Brym, Xomy, Xomy
Xomy, Xomy, Brym, Brym, Brym, Brym, Brym, Brym, Brym, Brym, Brym, Brym, Brym, Xomy, Xomy
Xomy, Xomy, Brym, Brym, Brym, Brym, Brym, Brym, Brym, Brym, Brym, Brym, Brym, Xomy, Xomy
Xomy, Xomy, Xomy, Brym, Brym, Brym, Brym, Brym, Brym, Brym, Brym, Brym, Xomy, Xomy, Xomy
Xomy, Xomy, Xomy, Xomy, Xomy, Brym, Brym, 1 Brym, Brym, Brym, Xomy, Xomy, Xomy, Xomy, Xomy
Xomy, Xomy, Xomy, Xomy, Xomy, Xomy, Xomy, Brym, Xomy, Xomy, Xomy, Xomy, Xomy, Xomy, Xomy
Xomy, Xomy, Xomy, Xomy, Xomy, Xomy, Xomy, Btym^Bydc, Xomy, Xomy, Xomy, Xomy, Xomy, Xomy, Xomy
Xomy, Xomy, Xomy, Xomy, Xomy, Xomy, Xomy, Brym, Xomy, Xomy, Xomy, Xomy, Xomy, Xomy, Xomy
