border_size=1
usage=map

Wuy, Mybd, Wuy, Mybd, Wuy, Wuy, Wuy, Wuy, Wuy, Wuy, Wuy, Wuy, Wuy, Wuy, Wuy, Wuy, Ayb, Ayb, Ayb, Ayb, Ayb, Wwby, Wwby, Woby, Wwby, Woby, Woby, Woby, Woby, Tyb, Tyb, Tyb, Tyb, Tyb, Tyb, Tyb, Tyb
Mybd, Wuy, Mybd, Wuy, Wuy, Wuy, Mybd^Eyt, Mybd, Mybd^Eyt, Wuy, Mybd, Mybd^Eyt, Mybd, Mybd, Wuy, Wuy, Wuy, Ayb, Ayb, Ayb, Wwby, Wwby, Wwby, Wwby, Woby, Woby, Woby, Woby, Woby, Tyb, Tyb, Tyb, Tyb, Tyb, Kpy, Tyb, Tyb
Mybd, Mybd, Mybd, Wuy, Wuy, Wuy, Mybd, Mybd^Eyt, Mybd^Eyt, Mybd^Eyt, Mybd, Mybd, Wuy, Wuy, Wuy, Wuy, Wuy, Ayb, Ayb, Ayb, Wwby, Wwby, Wwby, Wwby, Woby, Woby, Woby, Woby, Woby, Tyb, Tyb, Tyb, Tyb, Tyb, Tyb, Tyb, Tyb
Mybd, Uu^Vyb, Mybd, Mybd, Wuy, Wuy, Wuy, Mybd, Mybd, Mybd, Mybd, Mybd, Wuy, Wuy, Mybd, Wuy, Wuy, Ayb, Ayb, Ayb, Ayb, Wwby, Wwby, Wwby, Wwby, Woby, Woby, Woby, Woby, Woby, Woby, Tyb, Tyb, Tyb, Tyb, Tyb, Tyb
Mybd, Mybd, Mybd, Mybd, Wuy, Wuy, Wuy, Wuy, Wuy, Mybd, Mybd, Mybd, Wuy, Wuy, Mybd, Wuy, Wuy, Wuy, Ayb, Ayb, Ayb, Wwby, Wwby, Wwby, Wwby, Woby, Woby, Woby, Woby, Woby, Woby, Tyb, Woby, Tyb, Tyb, Tyb, Tyb
Mybd, Mybd, Wuy, Wuy, Wuy, Wuy, Mybd^Fyod, Wuy, Wuy, Wuy, Mybd, Mybd, Wuy, Wuy, Mybd, Mybd, Wuy, Wuy, Ayb, Ayb, Ayb, Ayb, Wwby, Wwby, Wwby, Wwby, Woby, Woby, Woby, Woby, Woby, Woby, Woby, Woby, Woby, Tyb, Woby
Mybd, Mybd, Wuy, Wuy, Mybd, Mybd^Fyod, Mybd^Fyod, Mybd^Fyod, Mybd^Fyod, Wuy, Mybd, Mybd, Wuy, Wuy, Mybd, Mybd, Mybd, Wuy, Wuy, Ayb, Ayb, Ayb, Ayb, Wwby, Wwby, Wwby, Wwby, Woby, Wwby, Woby, Woby, Woby, Woby, Woby, Woby, Woby, Woby
Mybd, Mybd, Wuy, Wuy, Mybd, Mybd^Fyod, Mybd, Mybd^Fyod, Mybd, Mybd, Mybd, Mybd, Mybd, Wuy, Mybd, Mybd, Mybd, Wuy, Wuy, Wuy, Ayb, Ayb, Ayb, Wwby, Wwby, Wwby, Wwby, Wwby, Wwby, Woby, Wwby, Woby, Woby, Woby, Woby, Woby, Woby
Mybd, Mybd, Wuy, Wuy, Mybd, Mybd, Mybd, Mybd, Mybd, Mybd, Wuy, Mybd, Wuy, Mybd, Mybd, Mybd, Wuy, Wuy, Wuy, Wuy, Wuy, Ayb, Ayb, Ayb, Ayb, Wwby, Wwby, Wwby, Wwby, Wwby, Wwby, Wwby, Wwby, Wwby, Wwby, Woby, Wwby
Mybd, Mybd, Wuy, Wuy, Mybd, Mybd, Wuy, Mybd, Wuy, Wuy, Wuy, Wuy, Wuy, Wuy, Wuy, Wuy, Mybd, Wuy, Mybd, Wuy, Wuy, Wuy, Wuy, Ayb, Ayb, Ayb, Ayb, Ayb, Ayb, Wwby, Wwby, Wwby, Wwby, Wwby, Wwby, Wwby, Wwby
Fyp^Gsye, Fyp^Gsye, Mybd, Wuy, Mybd, Mybd, Wuy, Wuy, Wuy, Wuy, Mybd^Eyt, Wuy, Mybd^Pyg, Wuy, Mybd, Mybd, Mybd, Mybd, Mybd, Mybd, Urfz, Wuy, Wuy, Wuy, Wuy, Ayb, Ayb, Ayb, Ayb, Ayb, Ayb, Wwby, Wwby, Wwby, Wwby, Wwby, Wwby
Mybd, Mybd, Mybd, Mybd, Pryf, Mybd, Wuy, Wuy, Mybd, Mybd, Mybd, Mybd^Pyg, Pryf, Mybd^Pyg, Mybd, Wuy, Wuy, Wuy, Mybd^Bryb, Mybd, Mybd, Mybd, Mybd, Wuy, Wuy, Wuy, Wuy, Ayb, Ayb, Ayb, Ayb, Wwby, Wwby, Wwby, Wwby, Wwby, Wwby
Mybd, Mybd, Pryf, Mybd, Mybd, Mybd, Wuy, Wuy, Mybd, Mybd^Vypr, Mybd, Mybd^Vypr, Mybd, Mybd, Qxu, Qxu, Wuy, Wuy, Wuy, Mybd^Bryb, Mybd^Bryb, Mybd, Mybd, Urfz, Urfz, Wuy, Wuy, Wuy, Wuy, Ayb, Ayb, Ayb, Ayb, Wwby, Ayb, Wwby, Ayb
Mybd, Mybd, Mybd, Mybd, Mybd, Mybd, Wuy, Wuy, Wuy, Mybd, Mybd, Mybd, Mybd^Vypr, Mybd, Qxu, Qxu, Qxu, Wuy, Wuy, Wuy, Wuy, Mybd^Bryb, Wuy, Mybd, Mybd, Urfz, Mybd, Wuy, Wuy, Wuy, Ayb, Ayb, Ayb, Ayb, Ayb, Ayb, Ayb
Mybd, Mybd, Wuy, Mybd, Mybd, Mybd, Mybd, Wuy, Wuy, Wuy, Wuy, Mybd, Urfz, Mybd, Qxu, Qxu, Qxu, Qxu, Wuy, Wuy, Wuy, Wuy, Wuy, Wuy, Wuy, Mybd, Mybd, Mybd, Wuy, Wuy, Wuy, Ayb, Ayb, Ayb, Ayb, Ayb, Ayb
Mybd, Wuy, Wuy, Mybd, Mybd, Mybd, Mybd^Vypr, Mybd, Mybd, Wuy, Wuy, Uzw, Urfz, Mybd, Mybd, Qxu, Qxu, Qxu, Wuy, Wuy, Urfz, Wuy, Mybd, Wuy, Wuy, Wuy, Mybd, Mybd, Mybd, Wuy, Wuy, Wuy, Wuy, Wuy, Wuy, Ayb, Wuy
Mybd, Wuy, Wuy, Mybd, Mybd, Mybd, Urfz, Urfz, Uzw, Wuy, Wuy, Uzw, Mybd, Urfz, Mybd, Mybd, Wuy, Wuy, Wuy, Wuy, Urfz, Urfz, Urfz, Uzw, Mybd, Mybd, Mybd, Mybd, Wuy, Wuy, Wuy, Wuy, Fyp, Wuy, Wuy, Wuy, Wuy
Wuy, Wuy, Wuy, Mybd, Mybd^Vypr, Mybd, Mybd, Urfz, Uzw, Wuy, Wuy, Uzw, Mybd, Mybd^Vypr, Mybd, Wuy, Wuy, Wuy, Wuy, Wuy, Wuy, Uzw, Uzw, Pryf, Urfz, Wuy, Wuy, Wuy, Wuy, Wuy, Wuy, Wuy, Fyp, Fypd, Fypd, Wuy, Wuy
Wuy, Wuy, Mybd, Mybd, Mybd, Mybd, Mybd^Vypr, Mybd, Mybd, Wuy, Uzw, Mybd, Mybd, Uzw, Uzw, Wuy, Wuy, Mybd, Mybd, Wuy, Wuy, Wuy, Wuy, Urfz, Urfz, Wuy, Wuy, Wuy, Mybd, Mybd, Wuy, Wuy, Wuy, Fypd, Fypd, Wuy, Wuy
Wuy, Wuy, Mybd, Mybd, Mybd, Mybd, Mybd, Mybd, Uzw, Uzw, Uzw, Uzw, Urfz, Uzw, Wuy, Wuy, Wuy, Mybd, Mybd, Mybd, Mybd, Wuy, Wuy, Wuy, Mybd, Mybd, Mybd, Fyp^Gsyw, Fyp^Gsyw, Mybd, Wuy, Wuy, Wuy, Fyp, Fypd, Wuy, Wuy
Wuy, Mybd, Mybd, Mybd, Mybd, Mybd, Wuy, Mybd, Wuy, Urfz, Urfz, Urfz, Wuy, Wuy, Wuy, Wuy, Mybd, Mybd, Mybd, Mybd, Mybd, Mybd, Wuy, Wuy, Mybd, Urfz, Urfz, Mybd, Wuy, Wuy, Wuy, Wuy, Wuy, Mybd, Mybd, Fyp, Wuy
Wuy, Mybd, Wuy, Wuy, Wuy, Wuy, Wuy, Wuy, Wuy, Wuy, Wuy, Wuy, Wuy, Wuy, Wuy, Wuy, Wuy, Mybd, Mybd, Mybd, Mybd, Mybd, Urfz^Gtye, Wuy, Mybd, Mybd, Mybd, Wuy, Wuy, Wuy, Wuy, Wuy, Wuy, Wuy, Fyp, Fypd, Wuy
Wuy, Mybd, Wuy, Wuy, Wuy, Wuy, Urb, Urb, Fypd, Wuy, Urb, Wuy, Pryf, Pryf, Pryf, Wuy, Wuy, Wuy, Wuy, Wuy, Wuy, Urfz^Gtye, Urfz, Mybd, Mybd, Mybd, Pryf, Mybd^Pyg, Mybd, Mybd, Mybd, Wuy, Mybd, Wuy, Mybd, Fyp, Wuy
Wuy, Mybd, Mybd^Bryb, Mybd, Mybd, Mybd, Urb, Urb, Fypd^Fypp, Urb, Urb, Pryf, Cydy, Cydy, Cydy, Pryf, Urb, Wuy, Wuy, Wuy, Wuy, Wuy, Wuy, Urfz, Wuy, Mybd^Pyg, Mybd^Pyg, Mybd, Mybd, Mybd, Mybd, Mybd, Mybd, Mybd, Mybd, Mybd, Wuy
Wuy, Mybd, Mybd, Mybd, Mybd, Cmy, Urb, Fypd, Fypd, Fypd, Urb, Pryf, Cydy, 2 Kydy, Cydy, Pryf, Urb, Urb, Fypd, Urb, Urb, Wuy, Wuy, Wuy, Wuy, Wuy, Wuy, Wuy, Wuy, Mybd, Wuy, Mybd, Wuy, Mybd, Wuy, Wuy, Wuy
Wuy, Mybd, Mybd, Mybd, Mybd, Mybd, Mybd, Urb, Urb, Urb, Urb, Pryf, Pryf, Cydy, Pryf, Pryf, Urb, Fyp, Urb, Urb, Cmy, Mybd, Mybd, Wuy, Mybd, Wuy, Mybd, Wuy, Wuy, Wuy, Wuy, Wuy, Wuy, Wuy, Wuy, Wuy, Wuy
Wuy, Wuy, Wuy, Mybd, Mybd, Mybd, Mybd, Cmy, Mybd, Urb, Urb, Urb, Urb, Pryf, Urb, Urb, Urb, Fypd, Urb, Urb, Mybd, Mybd, Mybd, Mybd, Mybd, Mybd, Mybd^Vypr, Mybd, Mybd, Mybd, Mybd, Wuy, Wuy, Wuy, Wuy, Wuy, Wuy
Wuy, Wuy, Wuy, Wuy, Mybd, Mybd, Mybd, Mybd, Mybd, Mybd, Cmy, Urb, Urb, Urb, Urb, Urb, Urb, Urb, Cmy, Mybd, Mybd, Mybd, Mybd, Mybd, Mybd, Mybd, Mybd, Mybd, Mybd, Mybd, Mybd, Wuy, Wuy, Wuy, Wuy, Wuy, Wuy
Wuy, Wuy, Wuy, Wuy, Wuy, Mybd, Mybd, Mybd, Mybd, Mybd, Mybd, Mybd, Mybd, Urb, Cmy, Urb, Mybd, Mybd, Mybd, Mybd, Mybd, Mybd, Mybd, Mybd, Mybd, Mybd, Mybd, Mybd, Mybd^Vypr, Mybd, Mybd, Mybd, Mybd, Wuy, Wuy, Wuy, Wuy
Wuy, Wuy, Wuy, Wuy, Wuy, Wuy, Mybd, Mybd, Mybd, Mybd, Mybd, Mybd, Mybd, Mybd, Mybd, Mybd, Mybd, Mybd, Mybd, Mybd, Mybd, Mybd, Mybd, Mybd, Wwby, Mybd, Mybd, Mybd, Mybd, Mybd, Mybd, Mybd, Mybd, Mybd, Wuy, Wuy, Wuy
Wuy, Wuy, Wuy, Wuy, Wuy, Wuy, Mybd, Mybd, Mybd, Mybd, Mybd, Mybd, Mybd, Mybd, Mybd, Mybd, Mybd, Mybd, Mybd, Mybd, Mybd, Mybd, Mybd, Wwby, Wwby^Fynt, Wwby, Mybd, Mybd, Mybd, Mybd, Mybd, Mybd, Mybd, Mybd, Mybd, Wuy, Wuy
Wuy, Wuy, Wuy, Wuy, Mybd, Mybd, Mybd, Mybd, Mybd, Mybd, Wwby, Wwby, Wwby, Mybd, Mybd, Mybd, Mybd, Mybd, Mybd, Mybd, Mybd, Mybd, Mybd, Wwby, Wwby, Wwby, Mybd, Mybd, Mybd, Mybd^Vypr, Mybd, Mybd, Mybd, Mybd, Mybd, Wuy, Wuy
Mybd, Mybd^Vypr, Mybd, Mybd, Mybd, Mybd, Mybd, Mybd, Mybd, Mybd, Wwby, Wwby^Fynt, Wwby, Mybd, 1 Mybd, Mybd, Mybd, Mybd, Mybd, Mybd, Mybd, Mybd, Mybd, Mybd, Mybd, Mybd, Mybd, Mybd, Mybd, Mybd, Mybd, Mybd, Mybd, Mybd, Mybd, Wuy, Wuy
Mybd, Mybd, Mybd, Mybd, Mybd, Mybd, Mybd^Vypr, Mybd, Mybd, Mybd, Mybd, Wwby, Mybd, Mybd, Mybd, Mybd, Mybd, Mybd, Mybd, Mybd, Mybd, Mybd, Mybd, Mybd, Mybd, Mybd, Mybd, Mybd, Mybd, Mybd, Mybd, Mybd, Mybd, Mybd, Wuy, Wuy, Wuy
Mybd, Mybd, Mybd, Mybd, Mybd, Mybd, Mybd, Mybd, Mybd, Mybd, Mybd, Mybd, Mybd, Mybd, Mybd, Mybd, Mybd, Mybd, Mybd^Vypr, Mybd, Mybd, Mybd, Mybd, Mybd, Mybd, Mybd^Vypr, Mybd, Mybd, Mybd, Mybd, Mybd, Mybd, Mybd, Wuy, Wuy, Wuy, Wuy
Mybd, Mybd, Mybd^Vypr, Mybd, Mybd, Mybd, Mybd, Mybd, Mybd, Mybd, Mybd, Mybd, Mybd, Mybd, Mybd, Mybd, Mybd, Mybd, Mybd, Mybd, Mybd, Mybd, Mybd, Mybd, Mybd, Mybd, Mybd, Mybd, Mybd, Mybd, Mybd, Mybd, Wuy, Wuy, Wuy, Wuy, Wuy
Mybd, Mybd, Mybd, Mybd, Mybd, Mybd, Mybd, Mybd, Mybd, Mybd, Mybd, Mybd, Mybd, Mybd, Mybd, Mybd, Mybd, Mybd, Mybd, Mybd, Mybd, Mybd, Mybd, Mybd, Mybd, Mybd, Mybd, Mybd, Mybd, Mybd, Mybd, Wuy, Wuy, Wuy, Wuy, Wuy, Wuy
