border_size=1
usage=map

Btym, Btym, Btym, Btym, Btym, Btym, Btym, Btym, Btym, Btym, Btym, Btym, Btym, Btym, Btym, Btym, Btym, Btym, Btym, Btym, Btym, Btym, Btym, Btym, Btym
Btym, Btym, Btym, Btym, Btym, Btym, Btym, Btym, Btym, Btym, Btym, Btym, Brym^Bryb, Btym, Btym, Btym, Btym, Btym, Btym, Btym, Btym, Btym, Btym, Btym, Btym
Btym, Btym, Btym, Btym, Btym, Btym, Btym, Btym, Btym, Btym, Brym, Brym, Brym, Brym, Brym, Btym, Btym, Btym, Btym, Btym, Btym, Btym, Btym, Btym, Btym
Btym, Btym, Btym, Btym, Btym, Btym, Btym, Btym, Brym, Brym, Brym, Brym, Kmy, Brym, Brym, Brym, Brym, Btym, Btym, Btym, Btym, Btym, Btym, Btym, Btym
Btym, Btym, Btym, Btym, Btym, Btym, Brym, Brym, Brym, Brym, Brym, Brym, Brym, Brym, Brym, Brym, Brym, Brym, Brym, Btym, Btym, Btym, Btym, Btym, Btym
Btym, Btym, Btym, Btym, Brym, Brym, Brym, Brym, Brym, Cmy, Brym, Brym, Brym, Brym, Brym, Cmy, Brym, Brym, Brym, Brym, Brym, Btym, Btym, Btym, Btym
Xomy, Btym^Bydc, Brym^Bryb, Brym, Brym, Brym, Brym, Brym, Brym, Brym, Brym, Brym, Brym, Brym, Brym, Brym, Brym, Brym, Brym, Brym, Brym, Brym, Brym^Bryb, Btym, Btym
Xomy, Brym, Brym, Brym, Brym, Brym, Brym, Brym, Brym, Cmy, Brym, Brym, Brym, Brym, Brym, Cmy, Brym, Brym, Brym, Btyb, Brym^Lyml, Brym, Brym, Brym, Xomy
Xomy, Brym, Brym, Brym^Vymb, Brym, Btyb, Brym, Brym, Brym, Brym, Brym, Brym, Cmy, Brym, Brym, Brym, Brym, Brym, Brym, Btym, Brym^Lyml, Brym, Brym, Brym, Xomy
Xomy, Brym, Brym, Brym, Brym, Btym, Brym, Brym, Brym, Brym, Brym, Brym, Brym, Brym, Brym, Brym, Brym, Brym, Brym, Btym, Brym, Brym^Vymb, Brym, Brym, Xomy
Xomy, Brym, Brym, Brym^Lymp, Brym, Btym, Brym, Brym, Brym, Brym, Brym, Brym, Brym, Brym, Brym, Brym, Brym, Brym, Brym^Vymb, Brym, Brym, Brym, Brym^Lymp, Brym, Xomy
Xomy, Brym, Brym, Btyb, Brym, Brym, Brym, Brym, Brym, Brym, Brym, Brym, Brym, Brym, Brym, Brym, Btyb, Brym, Brym, Brym, Brym, Brym, Brym, Brym, Xomy
Xomy, Brym, Brym, Btym, Brym, Brym, Brym^Vymb, Brym, Brym, Brym, Brym, Brym, Brym, Brym, Brym, Brym, Btym, Brym, Brym, Brym, Brym, Brym^Vymb, Brym, Brym, Xomy
Xomy, Brym, Brym, Btym, Brym, Brym, Brym, Brym, Btyb, Brym, Brym, Brym, Brym, Brym, Brym, Brym, Btym, Brym, Brym^Vymb, Brym, Brym, Brym, Brym, Brym, Xomy
Brym, Brym^Bryb, Brym, Brym, Brym, Brym, Brym, Brym, Btym, Brym, Brym, Brym, Re^Asty, Brym, Brym, Brym, Brym, Brym, Brym, Brym, Brym, Brym, Brym, Brym^Bryb, Brym
Brym, Btyb, Btyb, Btyb, Btyb, Brym, Brym, Brym, Btym, Brym, Brym, Brym, Brym, Brym, Brym, Brym, Brym, Brym, Brym, Brym, Btyb, Btyb, Btyb, Btyb, Btyb
Btym, Btym, Btym, Btym, Btym, Brym, Brym, Brym, Brym, Brym, Brym, Brym, Brym, Brym, Brym, Brym, Brym, Brym, Brym, Brym, Btym, Btym, Btym, Btym, Btym
Brym, Btym, Btym, Btym, Btym, Btym, Btym^Sy|, Btym, Btym, Btym, Btym^Sy|, Btym, Btym^Sy|, Btym, Btym^Sy|, Btym, Btym, Btym, Btym^Sy|, Btym, Btym, Btym, Btym, Btym, Btym
Brym, Brym, Brym, Brym, Brym, Brym, Brym, Brym, Brym^Bryb, Brym, Brym, Brym, Brym, Brym, Brym, Brym, Brym^Bryb, Brym, Brym, Brym, Brym, Brym, Brym, Brym, Xomy
Xomy, Brym, Brym, Brym, Brym, Brym, Brym, Brym, Brym^Vymb, Brym, Brym, Brym, Brym^Fynt, Brym, Brym, Brym, Brym, Brym, Brym, Brym, Xomy, Brym, Brym, Brym, Xomy
Xomy, Xomy, Xomy, Brym^Bryb, Xomy, Brym, Brym, Brym, Brym, Brym, Brym, Brym, Brym, Brym, Brym, Brym^Vymb, Brym, Brym, Xomy, Xomy, Xomy, Xomy, Brym, Brym, Xomy
Xomy, Xomy, Xomy, Xomy, Xomy, Xomy, Xomy, Xomy, Xomy, Xomy, Xomy, Brym, Brym, Brym, Brym^Vymb, Brym, Brym^Bryb, Xomy, Xomy, Xomy, Brym, Brym, Brym, Brym, Xomy
Xomy, Xomy, Xomy, Xomy, Xomy, Xomy, Xomy, Xomy, Xomy, Xomy, Xomy, Brym, Brym, Brym, Brym, Brym, Xomy, Xomy, Xomy, Brym, Brym, Brym, Xomy, Xomy, Xomy
Xomy, Xomy, Xomy, Xomy, Xomy, Xomy, Brym, Xomy, Brym, Xomy, Brym, Brym, Brym, Brym, Xomy, Xomy, Xomy, Xomy, Brym, Brym, Brym, Xomy, Xomy, Xomy, Brym
Xomy, Xomy, Xomy, Xomy, Brym, Brym, Brym, Brym, Brym, Brym, Brym, Brym, Brym, Xomy, Xomy, Xomy, Xomy, Brym, Brym, Brym, Brym, Brym, Brym, Brym, Brym
Xomy, Xomy, Brym, Brym, Brym, Brym, Xomy, Brym, Xomy, Brym, Xomy, Brym, Brym, Brym, Brym, Xomy, Xomy, Xomy, Brym, Brym, Brym, 1 Brym, Brym, Brym, Brym
Xomy, Xomy, Brym, Brym, Xomy, Xomy, Xomy, Xomy, Xomy, Xomy, Xomy, Xomy, Xomy, Brym, Brym, Brym, Xomy, Xomy, Xomy, Brym, Brym, Brym, Brym, Brym, Brym
