border_size=1
usage=map

Brym, Brym, Brym, Brym, Brym, Brym, Xomy, Xomy, Xomy, Xomy, _off^_usr, _off^_usr, _off^_usr, _off^_usr, _off^_usr, _off^_usr, _off^_usr, _off^_usr, _off^_usr, _off^_usr, _off^_usr, _off^_usr, _off^_usr, _off^_usr, _off^_usr, _off^_usr, _off^_usr, _off^_usr, _off^_usr, _off^_usr, _off^_usr, _off^_usr, Xomy, Xomy, Xomy, Xomy, Xomy, Xomy, Xomy, _off^_usr, _off^_usr, Xomy, Xomy, Xomy, Xomy, Xomy, Xomy, _off^_usr, _off^_usr, _off^_usr, _off^_usr
Brym, Brym, 1 Brym, Brym, Brym, Brym, Brym, Xomy, Xomy, Xomy, Xomy, _off^_usr, _off^_usr, _off^_usr, _off^_usr, _off^_usr, _off^_usr, _off^_usr, _off^_usr, _off^_usr, _off^_usr, _off^_usr, _off^_usr, _off^_usr, _off^_usr, _off^_usr, _off^_usr, _off^_usr, _off^_usr, _off^_usr, Xomy, Xomy, Xomy, Xomy, Xomy, Xomy, Xomy, Xomy, Xomy, Xomy, Xomy, Xomy, Xomy, Xomy, Brym, Xomy, Xomy, Xomy, _off^_usr, _off^_usr, _off^_usr
Brym, Brym, Brym, Brym, Brym, Brym, Brym, Xomy, Xomy, Xomy, Xomy, _off^_usr, _off^_usr, _off^_usr, Xomy, _off^_usr, _off^_usr, _off^_usr, _off^_usr, _off^_usr, _off^_usr, _off^_usr, _off^_usr, _off^_usr, _off^_usr, _off^_usr, _off^_usr, _off^_usr, Xomy, Xomy, Xomy, Xomy, Brym, Brym, Brym, Brym, Brym, Xomy, Brym, Xomy, Xomy, Xomy, Xomy, Brym, Brym, Brym, Xomy, Xomy, _off^_usr, _off^_usr, _off^_usr
Brym, Brym, Brym, Brym, Brym, Brym, Brym, Brym^Bryl, Xomy, Xomy, Xomy, Xomy, Xomy, Xomy, Xomy, Xomy, Xomy, _off^_usr, _off^_usr, _off^_usr, _off^_usr, _off^_usr, _off^_usr, _off^_usr, _off^_usr, _off^_usr, Xomy, Xomy, Xomy, Xomy, Brym, Brym, Brym, Brym, Btyb, Brym, Brym, Brym, Btyb, Brym^Bryl, Xomy, Xomy, Brym^Gyw, Brym, Xomy, Xomy, Xomy, Xomy, Xomy, _off^_usr, _off^_usr
Xomy, Brym, Brym, Brym, Brym, Brym, Brym, Brym, Brym, Xomy, Xomy, Xomy, Brym^Bryl, Xomy, Brym, Xomy, Xomy, Xomy, Xomy, _off^_usr, _off^_usr, _off^_usr, _off^_usr, _off^_usr, Xomy, Xomy, Xomy, Xomy, Brym, Brym, Brym, Brym, Xomy, Brym^Bryl, Btym, Brym, Brym, Brym, Btym, Brym, Xomy, Xomy, Brym, Xomy, Xomy, Xomy, Brym, Xomy, Xomy, Xomy, _off^_usr
Xomy, Xomy, Xomy, Brym^Bryl, Xomy, Brym, Brym, Brym, Brym^Gye, Brym^Gye, Brym, Brym, Brym, Brym, Btyb, Brym, Brym^Bryl, Xomy, Xomy, Xomy, Xomy, _off^_usr, Xomy, Xomy, Xomy, Xomy, Brym, Brym, Brym, Brym, Xomy, Xomy, Xomy, Xomy, Btym, Brym, Btym, Brym, Btym, Xomy, Xomy, Xomy, Brym, Xomy, Xomy, Brym, Brym, Brym, Xomy, Xomy, _off^_usr
_off^_usr, Xomy, Xomy, Xomy, Xomy, Xomy, Xomy, Brym^Gye, Brym, Brym, Brym, Brym, Brym, Brym, Btym, Brym, Brym, Brym, Brym, Xomy, Xomy, Xomy, Xomy, Xomy, Brym, Brym, Brym, Brym, Xomy, Xomy, Xomy, Xomy, Xomy, Xomy, Xomy, Btym, Brym, Btym, Xomy, Xomy, Xomy, Xomy, Brym, Xomy, Xomy, Brym, Brym, Brym, Xomy, Xomy, _off^_usr
_off^_usr, _off^_usr, _off^_usr, Xomy, Xomy, Xomy, Brym^Bryl, Brym, Btyb, Brym, Brym, Brym, Brym, Brym, Cmy, Brym, Brym, Brym, Brym, Brym, Brym, Xomy, Brym, Brym, Brym, Brym, Xomy, Xomy, Xomy, Xomy, Xomy, Xomy, Xomy, Xomy, Xomy, Brym, Brym, Brym, Xomy, Xomy, Xomy, Xomy, Xomy, Brym, Brym, Brym^Gyw, Xomy, Xomy, Xomy, Xomy, _off^_usr
_off^_usr, _off^_usr, _off^_usr, _off^_usr, Xomy, Xomy, Brym, Brym, Btym, Brym, Brym, Brym, Brym, Cmy, Kmy, Cmy, Brym, Brym, Brym, Brym, Brym, Brym, Brym, Brym, Brym, Xomy, Xomy, Xomy, Xomy, Xomy, Xomy, Xomy, Xomy, Xomy, Brym, Brym, Brym, Brym, Brym, Xomy, Xomy, Xomy, Xomy, Xomy, Brym, Xomy, Xomy, Xomy, _off^_usr, _off^_usr, _off^_usr
_off^_usr, _off^_usr, _off^_usr, _off^_usr, Xomy, Xomy, Xomy, Brym, Brym^Bryl, Brym, Brym, Btyb, Brym, Cmy, Cmy, Cmy, Brym, Brym, Brym, Btyb, Brym, Brym, Xomy, Brym, Brym, Brym, Brym, Xomy, Xomy, Xomy, Xomy, Xomy, Xomy, Brym^Bryl, Btyb, Brym, Brym, Brym, Btyb, Brym^Bryl, Xomy, Xomy, Xomy, Xomy, Brym, Xomy, Xomy, Xomy, _off^_usr, _off^_usr, _off^_usr
_off^_usr, _off^_usr, _off^_usr, _off^_usr, _off^_usr, Xomy, Xomy, Xomy, Xomy, Brym, Brym, Btym, Brym, Brym, Brym, Brym, Btyb, Btyb, Brym^Bryl, Btym, Xomy, Xomy, Xomy, Xomy, Xomy, Brym, Brym, Brym, Brym^Bryl, Xomy, Xomy, Xomy, Xomy, Brym, Btym, Brym, Brym, Brym, Btym, Brym, Xomy, Xomy, Xomy, Xomy, Brym, Xomy, Xomy, Xomy, Xomy, _off^_usr, Xomy
_off^_usr, _off^_usr, _off^_usr, _off^_usr, _off^_usr, _off^_usr, _off^_usr, Xomy, Xomy, Xomy, Xomy, Brym, Brym, Brym, Btyb, Brym, Btym, Btym, Xomy, Xomy, Xomy, Xomy, Xomy, Xomy, Xomy, Xomy, Brym, Brym, Xomy, Xomy, Xomy, Xomy, Xomy, Xomy, Btym, Btym, Btym, Btym, Btym, Xomy, Xomy, Xomy, Brym^Bryl, Brym, Brym, Xomy, Xomy, Xomy, Xomy, Xomy, Xomy
_off^_usr, _off^_usr, _off^_usr, _off^_usr, _off^_usr, _off^_usr, _off^_usr, _off^_usr, Xomy, Xomy, Xomy, Brym, Brym, Brym, Btym, Brym^Bryl, Xomy, Xomy, Xomy, Xomy, Xomy, Xomy, Xomy, Xomy, Xomy, Brym, Brym, Brym, Xomy, Xomy, _off^_usr, _off^_usr, Xomy, Xomy, Xomy, Brym, Brym, Brym, Xomy, Xomy, Xomy, Xomy, Xomy, Brym, Brym, Brym, Brym, Xomy, Xomy, Xomy, Xomy
_off^_usr, _off^_usr, _off^_usr, _off^_usr, _off^_usr, _off^_usr, Xomy, Xomy, Xomy, Xomy, Brym, Brym, Brym, Brym, Xomy, Xomy, Xomy, Xomy, Xomy, Xomy, Xomy, Xomy, Xomy, Xomy, Xomy, Brym, Brym, Xomy, Xomy, _off^_usr, _off^_usr, _off^_usr, Xomy, Xomy, Xomy, Brym, Brym, Brym, Brym, Xomy, Xomy, Xomy, Xomy, Xomy, Xomy, Xomy, Xomy, Brym, Brym, Xomy, Xomy
_off^_usr, _off^_usr, _off^_usr, _off^_usr, Xomy, Xomy, Xomy, Xomy, Brym, Brym, Brym, Brym, Brym, Brym, Xomy, Xomy, Xomy, Xomy, Xomy, Xomy, Xomy, Xomy, Xomy, Xomy, Xomy, Brym, Brym, Xomy, Xomy, _off^_usr, _off^_usr, _off^_usr, _off^_usr, Xomy, Xomy, Brym^Bryl, Brym, Brym, Brym, Brym, Brym, Xomy, Xomy, Xomy, Xomy, Xomy, Brym, Brym, Brym, Brym^Bryl, Xomy
Xomy, Xomy, Xomy, Xomy, Xomy, Xomy, Brym^Gyw, Brym, Brym, Brym, Brym, Brym, Xomy, Xomy, Xomy, Xomy, Xomy, Xomy, Brym, Xomy, Brym, Xomy, Brym^Ayb, Xomy, Xomy, Brym, Brym, Xomy, Xomy, _off^_usr, _off^_usr, _off^_usr, _off^_usr, Xomy, Xomy, Xomy, Xomy, Brym, Brym, Brym, Brym, Brym, Brym, Xomy, Brym, Brym, Xomy, Brym, Xomy, Xomy, Xomy
Xomy, Xomy, Xomy, Xomy, Brym, Brym, Brym, Brym^Gyw, Brym^Gyw, Brym, Xomy, Xomy, Xomy, Xomy, _off^_usr, Xomy, Xomy, Brym, Xomy, Brym, Brym, Brym^Eyt, Brym^Ayb, Xomy, Xomy, Brym, Brym, Xomy, Xomy, _off^_usr, _off^_usr, _off^_usr, _off^_usr, Xomy, _off^_usr, Xomy, Xomy, Xomy, Xomy, Brym, Brym^Bryl, Brym, Brym, Brym, Xomy, Xomy, Xomy, Xomy, Xomy, Xomy, _off^_usr
Xomy, Xomy, Xomy, Brym^Bryl, Brym, Brym, Brym, Brym, Xomy, Xomy, Xomy, Xomy, _off^_usr, _off^_usr, _off^_usr, Xomy, Xomy, Brym, Xomy, Xomy, Xomy, Brym^Ayb, Xomy, Xomy, Xomy, Brym, Brym, Xomy, Xomy, _off^_usr, _off^_usr, _off^_usr, _off^_usr, _off^_usr, _off^_usr, _off^_usr, _off^_usr, Xomy, Xomy, Xomy, Xomy, Brym, Brym, Xomy, Xomy, Xomy, Xomy, Xomy, _off^_usr, _off^_usr, _off^_usr
Xomy, Xomy, Xomy, Brym, Brym, Brym, Brym, Brym^Bryl, Xomy, Xomy, _off^_usr, _off^_usr, _off^_usr, _off^_usr, _off^_usr, Xomy, Xomy, Brym, Brym, Xomy, Xomy, Xomy, Xomy, Xomy, Brym, Brym, Brym^Bryl, Xomy, Xomy, _off^_usr, _off^_usr, _off^_usr, _off^_usr, _off^_usr, _off^_usr, _off^_usr, Xomy, Xomy, Xomy, Xomy, Brym, Brym, Brym, Xomy, Xomy, Xomy, Xomy, _off^_usr, _off^_usr, _off^_usr, _off^_usr
Xomy, Xomy, Xomy, Brym, Xomy, Xomy, Brym, Brym, Xomy, Xomy, Xomy, _off^_usr, _off^_usr, _off^_usr, _off^_usr, Xomy, Xomy, Xomy, Xomy, Brym, Brym, Xomy, Brym, Brym, Brym, Brym, Xomy, Xomy, Xomy, _off^_usr, _off^_usr, _off^_usr, _off^_usr, _off^_usr, Xomy, Xomy, Xomy, Xomy, Brym, Brym, Brym, Brym, Brym, Brym, Brym, Xomy, Xomy, Xomy, Xomy, _off^_usr, _off^_usr
Xomy, Xomy, Brym, Brym, Xomy, Xomy, Brym, Brym, Brym, Xomy, Xomy, Xomy, Xomy, _off^_usr, _off^_usr, _off^_usr, _off^_usr, Xomy, Xomy, Xomy, Xomy, Brym, Brym^Bryl, Brym, Xomy, Xomy, Xomy, Xomy, _off^_usr, _off^_usr, _off^_usr, _off^_usr, Xomy, Xomy, Xomy, Xomy, Brym, Brym, Brym, Brym, Xomy, Xomy, Xomy, Brym, Brym, Brym, Brym, Xomy, Xomy, Xomy, Xomy
Xomy, Xomy, Brym, Xomy, Xomy, Brym, Xomy, Xomy, Xomy, Brym, Brym, Xomy, Xomy, Xomy, Xomy, Xomy, Xomy, _off^_usr, _off^_usr, Xomy, Xomy, Xomy, Xomy, Xomy, Xomy, Xomy, _off^_usr, _off^_usr, _off^_usr, _off^_usr, Xomy, Xomy, Xomy, Xomy, Brym, Brym, Brym, Brym, Xomy, Xomy, Xomy, Xomy, Xomy, Xomy, Xomy, Brym, Brym, Brym, Brym, Xomy, Xomy
Xomy, Xomy, Brym, Xomy, Xomy, Brym, Brym, Xomy, Xomy, Xomy, Xomy, Brym, Brym^Gye, Xomy, Xomy, Xomy, Xomy, Xomy, Xomy, _off^_usr, _off^_usr, Xomy, Xomy, Xomy, _off^_usr, _off^_usr, Xomy, Xomy, Xomy, Xomy, Xomy, Xomy, Brym, Brym, Brym, Brym, Xomy, Xomy, Xomy, Xomy, _off^_usr, _off^_usr, _off^_usr, Xomy, Xomy, Xomy, Xomy, Brym, Brym, Brym^Bryl, Xomy
Xomy, Xomy, Brym, Xomy, Xomy, Xomy, Xomy, Brym^Gye, Xomy, Xomy, Xomy, Xomy, Xomy, Brym, Brym, Brym, Brym, Xomy, Xomy, Xomy, _off^_usr, _off^_usr, _off^_usr, _off^_usr, Xomy, Xomy, Xomy, Xomy, Brym, Xomy, Brym, Brym, Brym, Brym, Xomy, Xomy, Xomy, Xomy, _off^_usr, _off^_usr, _off^_usr, _off^_usr, _off^_usr, _off^_usr, Xomy, Xomy, Xomy, Brym, Brym, Brym^Bryl, Xomy
Xomy, Xomy, Brym, Xomy, Xomy, Xomy, Xomy, Brym, Brym, Xomy, Xomy, Xomy, Xomy, Xomy, Xomy, Brym, Brym, Brym, Xomy, Xomy, Xomy, _off^_usr, Xomy, Xomy, Xomy, Xomy, Brym, Brym, Brym, Brym, Brym, Brym, Brym, Brym, Xomy, Xomy, _off^_usr, _off^_usr, _off^_usr, _off^_usr, _off^_usr, _off^_usr, Xomy, Xomy, Xomy, Xomy, Brym, Brym, Brym, Xomy, Xomy
Xomy, Xomy, Xomy, Brym^Gye, Xomy, Xomy, Xomy, Xomy, Brym, Brym, Xomy, Xomy, Xomy, Xomy, Xomy, Xomy, Xomy, Xomy, Xomy, Xomy, Xomy, Xomy, Xomy, Xomy, Brym^Bryl, Brym, Brym, Brym, Xomy, Brym^Bryl, Xomy, Xomy, Brym, Brym, Xomy, Xomy, _off^_usr, _off^_usr, _off^_usr, _off^_usr, Xomy, Xomy, Xomy, Xomy, Brym, Brym, Brym, Brym, Brym, Xomy, Xomy
Xomy, Xomy, Xomy, Brym, Xomy, Xomy, Xomy, Brym, Brym, Brym, Xomy, Xomy, Xomy, Xomy, Xomy, Xomy, Xomy, Xomy, Xomy, Xomy, Brym, Xomy, Xomy, Xomy, Brym, Brym, Xomy, Xomy, Xomy, Xomy, Xomy, Xomy, Brym, Brym, Xomy, Xomy, _off^_usr, _off^_usr, Xomy, Xomy, Xomy, Xomy, Brym, Brym, Brym, Brym, Brym, Brym, Brym, Xomy, Xomy
Xomy, Brym, Brym, Brym, Xomy, Xomy, Xomy, Xomy, Xomy, Xomy, Xomy, Xomy, Xomy, Xomy, Xomy, Xomy, Xomy, Xomy, Brym, Brym, Xomy, Brym, Brym, Brym, Xomy, Brym, Xomy, Xomy, Xomy, Xomy, Xomy, Xomy, Brym, Brym, Xomy, Xomy, _off^_usr, _off^_usr, Xomy, Xomy, Brym^Bryl, Brym, Brym, Brym, Brym^Taby, Brym, Brym, Brym, Brym, Brym, Xomy
Xomy, Brym, Brym, Brym, Xomy, Xomy, _off^_usr, Xomy, _off^_usr, Xomy, _off^_usr, Xomy, Xomy, Xomy, Brym, Xomy, Brym, Brym^Gyw, Xomy, Xomy, Xomy, Xomy, Brym, Xomy, Xomy, Brym, Brym, Xomy, Xomy, Xomy, Xomy, Xomy, Brym, Brym, Xomy, Xomy, Xomy, _off^_usr, Xomy, Xomy, Brym, Brym, Brym^Taby, Brym, Brym, Brym, Brym, Brym, Brym^Taby, Brym, Xomy
Xomy, Xomy, Xomy, Xomy, Xomy, Xomy, _off^_usr, _off^_usr, _off^_usr, _off^_usr, _off^_usr, Xomy, Xomy, Brym^Ayb, Brym^Eyt, Brym, Xomy, Xomy, Xomy, Xomy, Brym, Brym, Xomy, Xomy, Xomy, Xomy, Xomy, Brym, Xomy, Xomy, Xomy, Xomy, Brym, Brym, Brym, Xomy, Xomy, Xomy, Xomy, Xomy, Brym, Brym, Brym, Brym, Brym, Brym^Fynt, Brym, Brym, Brym, Brym, Xomy
_off^_usr, Xomy, _off^_usr, Xomy, _off^_usr, _off^_usr, _off^_usr, _off^_usr, _off^_usr, _off^_usr, _off^_usr, Xomy, Xomy, Brym^Ayb, Brym^Ayb, Brym, Xomy, Xomy, Xomy, Brym, Xomy, Xomy, Xomy, Xomy, Xomy, Xomy, Xomy, Brym^Gye, Xomy, Xomy, Brym, Brym, Brym, Brym, Brym, Brym, Brym, Xomy, Xomy, Xomy, Brym^Bryl, Brym, Brym^Taby, Brym, Brym, Brym, Brym, Brym^Taby, Brym, Brym^Bryl, Xomy
_off^_usr, _off^_usr, _off^_usr, _off^_usr, _off^_usr, _off^_usr, _off^_usr, _off^_usr, _off^_usr, _off^_usr, _off^_usr, Xomy, Xomy, Xomy, Xomy, Xomy, Xomy, Xomy, Xomy, Brym^Gye, Xomy, Xomy, Xomy, Xomy, Xomy, Xomy, Xomy, Brym, Xomy, Xomy, Brym^Bryl, Btyb, Brym, Brym, Brym, Btyb, Brym^Bryl, Xomy, Xomy, Xomy, Xomy, Brym, Brym, Brym, Brym, Brym^Taby, Brym, Brym, Xomy, Xomy, Xomy
_off^_usr, _off^_usr, _off^_usr, _off^_usr, _off^_usr, _off^_usr, _off^_usr, _off^_usr, _off^_usr, _off^_usr, _off^_usr, _off^_usr, _off^_usr, Xomy, Xomy, Xomy, Xomy, Xomy, Xomy, Brym, Brym, Xomy, Xomy, Xomy, Xomy, Brym, Brym, Brym, Xomy, Xomy, Xomy, Btym, Btym, Brym, Btym, Btym, Xomy, Xomy, Xomy, Xomy, Xomy, Xomy, Xomy, Brym, Brym^Bryl, Brym, Xomy, Xomy, Xomy, Xomy, _off^_usr
_off^_usr, _off^_usr, _off^_usr, _off^_usr, _off^_usr, _off^_usr, _off^_usr, _off^_usr, _off^_usr, _off^_usr, _off^_usr, _off^_usr, _off^_usr, _off^_usr, _off^_usr, _off^_usr, Xomy, Xomy, Brym, Brym, Brym, Xomy, Xomy, Xomy, Xomy, Brym, Brym, Brym, Xomy, Xomy, Xomy, Btym, Brym, Btym, Brym, Btym, Xomy, Xomy, _off^_usr, _off^_usr, _off^_usr, Xomy, Xomy, Xomy, Xomy, Xomy, Xomy, Xomy, _off^_usr, _off^_usr, _off^_usr
_off^_usr, _off^_usr, _off^_usr, _off^_usr, _off^_usr, _off^_usr, _off^_usr, _off^_usr, _off^_usr, _off^_usr, _off^_usr, _off^_usr, _off^_usr, _off^_usr, _off^_usr, _off^_usr, Xomy, Xomy, Xomy, Brym, Xomy, Xomy, Xomy, Xomy, Xomy, Xomy, Xomy, Xomy, Xomy, Xomy, Xomy, Xomy, Xomy, Brym, Brym, Xomy, Xomy, Xomy, _off^_usr, _off^_usr, _off^_usr, _off^_usr, _off^_usr, Xomy, Xomy, Xomy, _off^_usr, _off^_usr, _off^_usr, _off^_usr, _off^_usr
_off^_usr, _off^_usr, _off^_usr, _off^_usr, _off^_usr, _off^_usr, _off^_usr, _off^_usr, _off^_usr, _off^_usr, _off^_usr, _off^_usr, _off^_usr, _off^_usr, _off^_usr, _off^_usr, _off^_usr, Xomy, Xomy, Xomy, Xomy, Xomy, _off^_usr, _off^_usr, _off^_usr, Xomy, Xomy, Xomy, _off^_usr, _off^_usr, _off^_usr, Xomy, Xomy, Brym, Brym, Xomy, Xomy, _off^_usr, _off^_usr, _off^_usr, _off^_usr, _off^_usr, _off^_usr, _off^_usr, _off^_usr, _off^_usr, _off^_usr, _off^_usr, _off^_usr, _off^_usr, _off^_usr
_off^_usr, _off^_usr, _off^_usr, _off^_usr, _off^_usr, _off^_usr, _off^_usr, _off^_usr, _off^_usr, _off^_usr, _off^_usr, _off^_usr, _off^_usr, _off^_usr, _off^_usr, _off^_usr, _off^_usr, _off^_usr, _off^_usr, Xomy, _off^_usr, _off^_usr, _off^_usr, _off^_usr, _off^_usr, _off^_usr, _off^_usr, _off^_usr, _off^_usr, _off^_usr, _off^_usr, Xomy, Xomy, Brym, Brym, Xomy, Xomy, Xomy, Xomy, _off^_usr, _off^_usr, _off^_usr, _off^_usr, _off^_usr, _off^_usr, _off^_usr, _off^_usr, _off^_usr, _off^_usr, _off^_usr, _off^_usr
_off^_usr, _off^_usr, _off^_usr, _off^_usr, _off^_usr, _off^_usr, _off^_usr, _off^_usr, _off^_usr, _off^_usr, _off^_usr, _off^_usr, _off^_usr, _off^_usr, _off^_usr, _off^_usr, _off^_usr, _off^_usr, _off^_usr, _off^_usr, _off^_usr, _off^_usr, Xomy, Xomy, Xomy, _off^_usr, _off^_usr, _off^_usr, _off^_usr, _off^_usr, _off^_usr, Xomy, Xomy, Brym, Brym, Brym, Brym, Xomy, Xomy, Xomy, _off^_usr, _off^_usr, _off^_usr, _off^_usr, Xomy, Xomy, Xomy, _off^_usr, _off^_usr, _off^_usr, _off^_usr
_off^_usr, _off^_usr, _off^_usr, _off^_usr, _off^_usr, _off^_usr, _off^_usr, _off^_usr, _off^_usr, _off^_usr, _off^_usr, _off^_usr, _off^_usr, _off^_usr, _off^_usr, _off^_usr, _off^_usr, _off^_usr, _off^_usr, _off^_usr, Xomy, Xomy, Xomy, Xomy, Xomy, Xomy, Xomy, _off^_usr, _off^_usr, _off^_usr, _off^_usr, Xomy, Xomy, Xomy, Xomy, Brym, Brym, Brym, Xomy, Xomy, _off^_usr, _off^_usr, _off^_usr, Xomy, Xomy, Xomy, Xomy, Xomy, Xomy, _off^_usr, _off^_usr
_off^_usr, _off^_usr, _off^_usr, _off^_usr, _off^_usr, _off^_usr, _off^_usr, _off^_usr, _off^_usr, _off^_usr, _off^_usr, _off^_usr, _off^_usr, _off^_usr, _off^_usr, _off^_usr, _off^_usr, _off^_usr, _off^_usr, Xomy, Xomy, Xomy, Brym, Brym, Brym, Xomy, Xomy, Xomy, Xomy, Xomy, Xomy, Xomy, Xomy, Xomy, Xomy, Xomy, Brym, Brym, Xomy, Xomy, _off^_usr, _off^_usr, _off^_usr, Xomy, Xomy, Brym, Brym, Xomy, Xomy, Xomy, _off^_usr
_off^_usr, _off^_usr, _off^_usr, _off^_usr, _off^_usr, _off^_usr, _off^_usr, _off^_usr, _off^_usr, _off^_usr, _off^_usr, _off^_usr, _off^_usr, _off^_usr, _off^_usr, _off^_usr, _off^_usr, _off^_usr, _off^_usr, Xomy, Xomy, Brym, Brym, Brym, Xomy, Brym, Brym^Gye, Xomy, Brym, Xomy, Xomy, Xomy, Brym, Brym^Bryl, Brym, Xomy, Brym, Brym, Xomy, Xomy, _off^_usr, _off^_usr, _off^_usr, Xomy, Xomy, Brym, Brym, Brym, Xomy, Xomy, _off^_usr
_off^_usr, _off^_usr, _off^_usr, _off^_usr, _off^_usr, _off^_usr, _off^_usr, _off^_usr, _off^_usr, _off^_usr, _off^_usr, _off^_usr, _off^_usr, _off^_usr, _off^_usr, _off^_usr, _off^_usr, _off^_usr, _off^_usr, Xomy, Xomy, Xomy, Xomy, Xomy, Xomy, Xomy, Xomy, Brym, Xomy, Brym, Brym, Brym, Brym, Brym, Brym, Brym, Brym, Brym, Xomy, Xomy, _off^_usr, _off^_usr, _off^_usr, Xomy, Xomy, Xomy, Brym, Xomy, Xomy, Xomy, _off^_usr
_off^_usr, _off^_usr, _off^_usr, _off^_usr, _off^_usr, _off^_usr, _off^_usr, _off^_usr, _off^_usr, _off^_usr, _off^_usr, _off^_usr, _off^_usr, _off^_usr, _off^_usr, _off^_usr, _off^_usr, _off^_usr, _off^_usr, _off^_usr, _off^_usr, Xomy, Xomy, Xomy, _off^_usr, Xomy, Xomy, Xomy, Xomy, Xomy, Brym^Bryl, Brym, Brym, Brym, Brym, Brym, Brym, Brym, Xomy, Xomy, Xomy, _off^_usr, Xomy, Xomy, Xomy, Xomy, Brym^Gyw, Xomy, Xomy, _off^_usr, _off^_usr
Woby^Xo, _off^_usr, _off^_usr, _off^_usr, Woby^Xo, _off^_usr, Woby^Xo, _off^_usr, Woby^Xo, _off^_usr, Woby^Xo, Woby^Xo, Woby^Xo, _off^_usr, Woby^Xo, _off^_usr, Woby^Xo, _off^_usr, Woby^Xo, _off^_usr, Woby^Xo, _off^_usr, Woby^Xo, _off^_usr, Woby^Xo, _off^_usr, _off^_usr, Xomy, Xomy, Xomy, Brym, Brym, Brym, Brym, Brym, Brym, Brym, Brym^Bryl, Xomy, Xomy, Xomy, Xomy, Xomy, Xomy, Brym, Brym, Xomy, Xomy, Xomy, _off^_usr, _off^_usr
Woby^Xo, Woby^Xo, Woby^Xo, Woby^Xo, Woby^Xo, Woby^Xo, Woby^Xo, Woby^Xo, Woby^Xo, Woby^Xo, Woby^Xo, Woby^Xo, Woby^Xo, Woby^Xo, Woby^Xo, Woby^Xo, Woby^Xo, Woby^Xo, Woby^Xo, Woby^Xo, Woby^Xo, Woby^Xo, Woby^Xo, Woby^Xo, Woby^Xo, Woby^Xo, _off^_usr, _off^_usr, Xomy, Xomy, Brym^Bryl, Brym, Brym, Brym, Brym, Brym, Brym, Brym, Brym, Xomy, Brym, Xomy, Xomy, Xomy, Brym, Xomy, Xomy, Xomy, _off^_usr, _off^_usr, _off^_usr
Woby^Xo, Woby^Xo, Woby^Xo, Woby^Xo, Woby, Woby^Xo, Woby, Woby^Xo, Woby, Woby^Xo, Woby, Woby^Xo, Woby, Woby^Xo, Woby, Woby^Xo, Woby, Woby^Xo, Woby, Woby^Xo, Woby^Xo, Woby^Xo, Woby, Woby^Xo, Woby^Xo, Woby^Xo, _off^_usr, _off^_usr, Xomy, Xomy, Xomy, Brym, Brym, Brym, Brym, Brym^Bryl, Xomy, Xomy, Xomy, Brym, Xomy, Brym, Brym, Brym, Xomy, Xomy, Xomy, _off^_usr, _off^_usr, _off^_usr, _off^_usr
Woby^Xo, Woby^Xo, Woby, Woby, Woby, Woby, Woby, Woby, Woby, Woby, Woby, Woby, Woby, Woby, Woby, Woby, Woby, Woby, Woby, Woby, Woby, Woby, Woby, Woby, Woby^Xo, Woby^Xo, _off^_usr, _off^_usr, _off^_usr, Xomy, Xomy, Xomy, Xomy, Brym, Xomy, Xomy, Xomy, Xomy, Xomy, Xomy, Xomy, Xomy, Xomy, Xomy, Xomy, Xomy, _off^_usr, _off^_usr, _off^_usr, _off^_usr, _off^_usr
Woby^Xo, Woby^Xo, Woby, Woby, Woby, Woby, Woby, Woby, Woby, Woby, Woby, Woby, Woby, Woby, Woby, Woby, Woby, Woby, Woby, Woby, Woby, Woby, Woby, Woby, Woby^Xo, Woby^Xo, _off^_usr, _off^_usr, _off^_usr, Xomy, Xomy, Xomy, Xomy, Brym, Xomy, Xomy, Xomy, Xomy, Xomy, Xomy, Xomy, Xomy, Xomy, Xomy, _off^_usr, _off^_usr, _off^_usr, _off^_usr, _off^_usr, _off^_usr, _off^_usr
Woby^Xo, Woby^Xo, Woby, Woby, Woby, Woby, Woby, Woby, Woby, Woby, Woby, Woby, Woby, Woby, Woby, Woby, Woby, Woby, Woby, Woby, Woby, Woby, Woby, Woby, Woby^Xo, Woby^Xo, _off^_usr, _off^_usr, _off^_usr, _off^_usr, Xomy, Xomy, Brym, Brym, Brym, Xomy, Brym, Xomy, Xomy, Xomy, Xomy, Xomy, Xomy, _off^_usr, _off^_usr, _off^_usr, _off^_usr, _off^_usr, _off^_usr, _off^_usr, _off^_usr
Woby^Xo, Woby^Xo, Woby, Woby, Woby, Woby, Woby, Woby, Woby, Woby, Woby, Woby, Woby, Woby, Woby, Woby, Woby, Woby, Woby, Woby, Woby, Woby, Woby, Woby, Woby^Xo, Woby^Xo, _off^_usr, _off^_usr, _off^_usr, _off^_usr, Xomy, Xomy, Brym, Xomy, Xomy, Brym, Xomy, Brym, Brym, Xomy, Brym^Gyw, Brym, Brym, Xomy, Xomy, _off^_usr, _off^_usr, _off^_usr, _off^_usr, _off^_usr, _off^_usr
Woby^Xo, Woby^Xo, Woby, Woby, Woby, Woby, Woby, Woby, Woby, Woby, Woby, Woby, Woby, Woby, Woby, Woby, Woby, Woby, Woby, Woby, Woby, Woby, Woby, Woby, Woby^Xo, Woby^Xo, _off^_usr, _off^_usr, _off^_usr, _off^_usr, Xomy, Xomy, Xomy, Brym^Gye, Brym, Xomy, Xomy, Xomy, Xomy, Brym, Xomy, Xomy, Brym, Woby, Xomy, Xomy, _off^_usr, _off^_usr, _off^_usr, _off^_usr, _off^_usr
Woby^Xo, Woby^Xo, Woby, Woby, Woby, Woby, Woby, Woby, Woby, Woby, Woby, Woby, Woby, Woby, Woby, Woby, Woby, Woby, Woby, Woby, Woby, Woby, Woby, Woby, Woby^Xo, Woby^Xo, _off^_usr, _off^_usr, _off^_usr, _off^_usr, Xomy, Xos, Xomy, Xomy, Xomy, Xomy, Xomy, Xomy, Xomy, Xomy, Xomy, Xomy, Woby, Woby, Xomy, Xomy, _off^_usr, _off^_usr, _off^_usr, _off^_usr, _off^_usr
_off^_usr, Woby^Xo, Woby, Woby, Woby, Woby, Woby, Woby, Woby, Woby, Woby, Woby, Woby, Gd^Fyok, Woby, Woby, Woby, Woby, Woby, Woby, Woby, Woby, Woby, Woby, Woby^Xo, Woby^Xo, _off^_usr, _off^_usr, _off^_usr, _off^_usr, Xomy, Xomy, Xos, Xomy, Xos, Xomy, Xos, Xomy, _off^_usr, Xomy, Xomy, Xomy, Xomy, Xomy, Xomy, Xomy, _off^_usr, _off^_usr, _off^_usr, _off^_usr, _off^_usr
Woby^Xo, Woby^Xo, Woby, Woby, Woby, Woby, Woby, Woby, Woby, Woby, Woby, Woby, Woby, Woby, Woby, Woby, Woby, Woby, Woby, Woby, Woby, Woby, Woby, Woby, Woby^Xo, Woby^Xo, _off^_usr, _off^_usr, Xomy, Xomy, Xos, Xol, Xos, Xol, Brym, Xos, Xol, Xol, _off^_usr, _off^_usr, _off^_usr, Xomy, Xomy, Xomy, _off^_usr, _off^_usr, _off^_usr, _off^_usr, _off^_usr, _off^_usr, _off^_usr
Woby^Xo, Woby^Xo, Woby, Woby, Woby, Woby, Woby, Woby, Woby, Woby, Woby, Woby, Woby, Woby, Woby, Woby, Woby, Woby, Woby, Woby, Woby, Woby, Woby, Woby, Woby^Xo, Woby^Xo, _off^_usr, _off^_usr, Xos, Xos, Brym, Brym, Brym, Brym, Brym, Xol, Xos, Xos, _off^_usr, _off^_usr, _off^_usr, _off^_usr, _off^_usr, _off^_usr, _off^_usr, _off^_usr, _off^_usr, _off^_usr, _off^_usr, _off^_usr, _off^_usr
Woby^Xo, Woby^Xo, Woby, Woby, Woby, Woby, Woby, Woby, Woby, Woby, Woby, Woby, Woby, Woby, Woby, Woby, Woby, Woby, Woby, Woby, Woby, Woby, Woby, Woby, Woby^Xo, Woby^Xo, _off^_usr, _off^_usr, Xos, Xol, Brym, Btyb, Brym, Btyb, Brym, Xol, Xos, _off^_usr, _off^_usr, _off^_usr, _off^_usr, _off^_usr, _off^_usr, _off^_usr, _off^_usr, _off^_usr, _off^_usr, _off^_usr, _off^_usr, _off^_usr, _off^_usr
_off^_usr, Woby^Xo, Woby, Woby, Woby, Woby, Woby, Woby, Woby, Woby, Woby, Woby, Woby, Woby, Woby, Woby, Woby, Woby, Woby, Woby, Woby, Woby, Woby, Woby, Woby^Xo, Woby^Xo, _off^_usr, _off^_usr, Xos, Xol, Brym, Btym, Btym^Sy|, Btym, Brym, Xol, Xos, _off^_usr, _off^_usr, _off^_usr, _off^_usr, _off^_usr, _off^_usr, _off^_usr, _off^_usr, _off^_usr, _off^_usr, _off^_usr, _off^_usr, _off^_usr, _off^_usr
Woby^Xo, Woby^Xo, Woby, Woby, Woby, Woby, Woby, Woby, Woby, Woby, Woby, Woby, Woby, Woby, Woby, Woby, Woby, Woby, Woby, Woby, Woby, Woby, Woby, Woby, Woby^Xo, Woby^Xo, _off^_usr, _off^_usr, Xos, Xos, Xos, Btym, Btym^Sy|, Btym, Xol, Xos, Xos, _off^_usr, _off^_usr, _off^_usr, _off^_usr, _off^_usr, _off^_usr, _off^_usr, _off^_usr, _off^_usr, _off^_usr, _off^_usr, _off^_usr, _off^_usr, _off^_usr
Woby^Xo, Woby^Xo, Woby, Woby, Woby, Woby, Woby, Woby, Woby, Woby, Woby, Woby, Woby, Woby, Woby, Woby, Woby, Woby, Woby, Woby, Woby, Woby, Woby, Woby, Woby^Xo, Woby^Xo, _off^_usr, _off^_usr, _off^_usr, Xos, Xos, Btym, Btym^Sy|, Btym, Xos, Xos, _off^_usr, _off^_usr, _off^_usr, _off^_usr, _off^_usr, _off^_usr, _off^_usr, _off^_usr, _off^_usr, _off^_usr, _off^_usr, _off^_usr, _off^_usr, _off^_usr, _off^_usr
Woby^Xo, Woby^Xo, Woby, Woby, Woby, Woby, Woby, Woby, Woby, Woby, Woby, Woby, Woby, Woby, Woby, Woby, Woby, Woby, Woby, Woby, Woby, Woby, Woby, Woby, Woby^Xo, Woby^Xo, _off^_usr, _off^_usr, _off^_usr, Xos, Xos, Btym, Urfz, Btym, Xos, Xos, _off^_usr, _off^_usr, _off^_usr, _off^_usr, _off^_usr, _off^_usr, _off^_usr, _off^_usr, _off^_usr, _off^_usr, _off^_usr, _off^_usr, _off^_usr, _off^_usr, _off^_usr
Woby^Xo, Woby^Xo, Woby, Woby, Woby, Woby, Woby, Woby, Woby, Woby, Woby, Woby, Woby, Woby, Woby, Woby, Woby, Woby, Woby, Woby, Woby, Woby, Woby, Woby, Woby^Xo, Woby^Xo, _off^_usr, _off^_usr, _off^_usr, Xos, Xos, Urfz, Urfz, Urfz, Xos, Xos, _off^_usr, _off^_usr, _off^_usr, _off^_usr, _off^_usr, _off^_usr, _off^_usr, _off^_usr, _off^_usr, _off^_usr, _off^_usr, _off^_usr, _off^_usr, _off^_usr, _off^_usr
Xue, Woby^Xo, Xue, Woby, Xue, Xue, Xue, Woby, Xue, Woby, Xue, Xue, Urb, Urb, Urb, Xue, Xue, Woby, Xue, Woby, Woby, Woby, Woby, Woby, Woby^Xo, Woby^Xo, _off^_usr, _off^_usr, _off^_usr, Xos, Xos, Urfz, Urfz, Urfz, Xos, Xos, _off^_usr, _off^_usr, _off^_usr, _off^_usr, _off^_usr, _off^_usr, _off^_usr, _off^_usr, _off^_usr, _off^_usr, _off^_usr, _off^_usr, _off^_usr, _off^_usr, _off^_usr
Xue, Xue, Xue, Xue, Xue, Xue, Xue, Xue, Xue, Xue, Xue, Xue, Xue, Urb, Xue, Xue, Xue, Xue, Xue, Xue, Xue, Woby, Xue, Xue, Xue, Xue, Xue, _off^_usr, _off^_usr, Xos, Xos, Urfz, Urfz, Xos, Xos, Xos, _off^_usr, _off^_usr, _off^_usr, _off^_usr, _off^_usr, _off^_usr, _off^_usr, _off^_usr, _off^_usr, _off^_usr, _off^_usr, _off^_usr, _off^_usr, _off^_usr, _off^_usr
Xue, Xue, Xue, Xue, _off^_usr, Xue, _off^_usr, Xue, Xue, Xue, Xue, Xue, Xue, Urb, Xue, Xue, Xue, Xue, Xue, Xue, Xue, Xue, Xue, Xue, Xue, Xue, _off^_usr, _off^_usr, Xos, Xos, Xos, Urfz, Urfz, Xos, Xos, Xos, _off^_usr, _off^_usr, _off^_usr, _off^_usr, _off^_usr, _off^_usr, _off^_usr, _off^_usr, _off^_usr, _off^_usr, _off^_usr, _off^_usr, _off^_usr, _off^_usr, _off^_usr
Xue, Xue, _off^_usr, _off^_usr, _off^_usr, _off^_usr, _off^_usr, _off^_usr, _off^_usr, _off^_usr, Xue, Xue, Xue, Urb, Xue, Xue, Xue, _off^_usr, _off^_usr, Xue, Xue, Xue, Xue, Xue, _off^_usr, _off^_usr, Xos, Xos, Xos, Xos, Urfz, Urfz, Urfz, Xos, Xos, _off^_usr, _off^_usr, _off^_usr, _off^_usr, _off^_usr, _off^_usr, _off^_usr, _off^_usr, _off^_usr, _off^_usr, _off^_usr, _off^_usr, _off^_usr, _off^_usr, _off^_usr, _off^_usr
_off^_usr, _off^_usr, _off^_usr, _off^_usr, _off^_usr, _off^_usr, _off^_usr, _off^_usr, _off^_usr, _off^_usr, Xue, Xue, Xue, Urb, Xue, Xue, Xue, _off^_usr, Xue, _off^_usr, Xue, Xue, Xos, Xos, Xos, Xos, Xos, Xos, Urfz, Urfz, Urfz, Urfz, Xos, Xos, Xos, _off^_usr, _off^_usr, _off^_usr, _off^_usr, _off^_usr, _off^_usr, _off^_usr, _off^_usr, _off^_usr, _off^_usr, _off^_usr, _off^_usr, _off^_usr, _off^_usr, _off^_usr, _off^_usr
_off^_usr, _off^_usr, _off^_usr, _off^_usr, _off^_usr, _off^_usr, _off^_usr, _off^_usr, _off^_usr, _off^_usr, _off^_usr, Xue, Xue, Urb, Urb, Xue, Xue, Xue, Xue, Xue, Xue, Xue, Xos, Xos, Xos, Xos, Urfz, Urfz, Urfz, Urfz, Xos, Xos, Xos, Xos, _off^_usr, _off^_usr, _off^_usr, _off^_usr, _off^_usr, _off^_usr, _off^_usr, _off^_usr, _off^_usr, _off^_usr, _off^_usr, _off^_usr, _off^_usr, _off^_usr, _off^_usr, _off^_usr, _off^_usr
_off^_usr, _off^_usr, _off^_usr, _off^_usr, _off^_usr, _off^_usr, _off^_usr, _off^_usr, _off^_usr, _off^_usr, _off^_usr, Xue, Xue, Xue, Xue, Urb, Urb, Xue, Urb, Xue, Urfz, Xue, Urfz, Urfz, Urfz, Urfz, Urfz, Urfz, Xos, Xos, Xos, Xos, _off^_usr, _off^_usr, _off^_usr, _off^_usr, _off^_usr, _off^_usr, _off^_usr, _off^_usr, _off^_usr, _off^_usr, _off^_usr, _off^_usr, _off^_usr, _off^_usr, _off^_usr, _off^_usr, _off^_usr, _off^_usr, _off^_usr
_off^_usr, _off^_usr, _off^_usr, _off^_usr, _off^_usr, _off^_usr, _off^_usr, _off^_usr, _off^_usr, _off^_usr, _off^_usr, _off^_usr, _off^_usr, Xue, Xue, Urb, Urb, Urb, Xue, Urfz, Xue, Urfz, Xos, Urfz, Xos, Xos, Xos, Xos, Xos, Xos, _off^_usr, _off^_usr, _off^_usr, _off^_usr, _off^_usr, _off^_usr, _off^_usr, _off^_usr, _off^_usr, _off^_usr, _off^_usr, _off^_usr, _off^_usr, _off^_usr, _off^_usr, _off^_usr, _off^_usr, _off^_usr, _off^_usr, _off^_usr, _off^_usr
_off^_usr, _off^_usr, _off^_usr, _off^_usr, _off^_usr, _off^_usr, _off^_usr, _off^_usr, _off^_usr, _off^_usr, _off^_usr, _off^_usr, _off^_usr, Xue, Xue, Xue, Xue, Xue, Xue, Xue, Xue, Xue, Xue, Xos, Xos, Xos, Xos, Xos, _off^_usr, _off^_usr, _off^_usr, _off^_usr, _off^_usr, _off^_usr, _off^_usr, _off^_usr, _off^_usr, _off^_usr, _off^_usr, _off^_usr, _off^_usr, _off^_usr, _off^_usr, _off^_usr, _off^_usr, _off^_usr, _off^_usr, _off^_usr, _off^_usr, _off^_usr, _off^_usr
