border_size=1
usage=map

Btym, Btym, Btym, Btym, Btym, Btym, Btym, Btym, Btym, Btym, Btym, Btym, Btym, Btym, Btym, Btym, Btym, Btym, Btym, Btym, Btym, Btym, Btym, Btym, Btym, Btym, Btym, Btym, Btym, Btym, Btym, Btym, Btym, Btym, Btym, Btym, Btym, Btym, Brym, Btym, Btym, Btym
Brym, Btym, Btym, Btym, Btym, Btym, Btym, Btym, Btym, Btym, Btym, Btym, Btym, Btym, Btym, Btym, Wwb, Wwb, Wwb, Btym, Btym, Btym, Btym, Btym, Btym, Btym, Btym, Btym, Btym, Btym, Btym, Btym, Btym, Btym, Btym, Btym, Btym, Btym, Brym, Btym, Btym, Btym
Brym, Brym, Brym, Btym, Btym, Btym, Btym, Btym, Btym, Btym, Btym, Btym, Btym, Btym, Urb, Urb, Ur, Urb, Wwb, Urb, Ur, Btym, Btym, Btym, Btym, Btym, Btym, Btym, Btym, Btym, Btym, Btym, Btym, Btym, Btym, Btym, Btym, Btym, Brym, Brym, Brym, Btym
Xomy, Brym, Brym, Brym, Brym, Btym, Btym, Btym, Btym, Btym, Btym, Btym, Wwb, Urb, Wwb, Urb, Urb, Ur, Ur, Ur, Ur, Urb, Brym, Btym, Btym, Btym, Btym, Btym, Btym, Btym, Btym, Btym, Btym, Btym, Btym, Btym, Btym, Btym, Brym, Brym, Brym, Btym
Xomy, Xomy, Xomy, Brym, Brym, Urb, Urb, Btym, Btym, Btym, Brym, Ur, Urb, Urb, Ur, Urb, Wwb, Urb, Urb, Urb, Urb, Urb, Urb, Urb, Brym, Btym, Btym, Btym, Btym, Btym, Btym, Btym, Btym, Btym, Btym, Btym, Btym, Btym, Urb, Brym, Urb, Brym
Xomy, Xomy, Xomy, Xomy, Xomy, Brym, Urb, Urb, Urb, Urb, Urb, Ur, Ur, Urb, Ur, Wwb, Wwb, Urb, Ur, Urb, Urb, Urb, Ur, Urb, Urb, Brym, Brym, Btym, Btym, Btym, Btym, Btym, Btym, Btym, Btym, Btym, Brym, Urb, Urb, Urb, Ur, Urb
Xomy, Xomy, Xomy, Xomy, Urb, Brym, Brym, Urb, Urb, Urb, Urb, Urb, Ur, Ur, Wwb, Wwb, Urb, Wwb, Wwb, Ur, Wwb, Urb, Ur, Urb, Urb, Urb, Brym, Brym, Brym, Btym, Btym, Btym, Btym, Btym, Brym, Brym, Urb, Urb, Ur, Ur, Ur, Urb
Xomy, Xomy, Ur, Urb, Btyb, Urb, Urb, Urb, Urb, Wwb, Wwb, Urb, Ur, Wwb, Wwb, Urb, Ur, Urb, Wwb, Ur, Wwb, Wwb, Wwb, Ur, Urb, Urb, Ur, Brym, Brym, Brym, Brym, Btym, Brym, Brym, Brym, Brym, Urb, Urb, Ur, Wwb, Wwb, Wwb
Urb, Ur, Wwb, Wwb, Btym, Urb, Urb, Urb, Wwb, Wwb, Ur, Urb, Urb, Wwb, Wwb, Ur, Ur, Urb, Wwb, Wwb, Wwb, Wwb, Wwb, Wwb, Ur, Ur, Ur, Urb, Brym, Brym, Btyb, Brym, Brym, Brym, Urb, Brym, Brym, Urb, Urb, Ur, Wwb, Wwb
Urb, Ur, Ur, Wwb, Btym, Urb, Urb, Urb, Wwb, Wwb, Btyb, Wwb, Urb, Urb, Ur, Wwb, Ur, Ur, Wwb, Wwb, Wwb, Wwb, Ur, Ur, Urb, Urb, Urb, Urb, Urb, Urb, Btym, Btyb, Urb, Urb, Urb, Urb, Brym, Urb, Urb, Wwb, Wwb, Urb
Urb, Urb, Urb, Ur, Btym, Urb, Urb, Ur, Ur, Wwb, Btym, Wwb, Urb, Urb, Urb, Ur, Ur, Ur, Ur, Wwb, Wwb, Wwb, Urb, Ur, Btyb, Urb, Wwb, Ur, Urb, Urb, Btym, Btym, Urb, Urb, Ur, Urb, Btyb, Brym, Urb, Urb, Urb, Wwb
Ur, Urb, Ur, Urb, Urb, Urb, Urb, Btyb, Ur, Ur, Btym, Btyb^Bryb, Ur, Ur, Urb, Ur, Urb, Ur, Ur, Urb, Urb, Urb, Ur, Urb, Btym, Ur, Ur, Wwb, Wwb, Urb, Urb, Btym, Urb, Ur, Ur, Urb, Btym, Brym, Brym, Urb, Urb, Urb
Urb, Ur, Wwb, Urb, Urb, Urb, Urb, Btym, Urb, Urb, Urb, Btym, Urb, Ur, Urb, Urb, Urb, Urb, Urb, Ur, Ur, Urb, Ur, Wwb, Btym, Wwb, Wwb, Wwb, Wwb, Urb, Ur, Urb, Wwb, Ur, Wwb, Urb, Btym, Brym, Brym, Brym, Brym, Brym
Urb, Ur, Wwb, Wwb, Ur, Urb, Urb, Btym, Urb, Ur, Ur, Btym, Urb, Ur, Ur, Urb, Brym, Brym^Rsty, Brym, Urb, Urb, Urb, Urb, Urb, Ur, Wwb, Wwb, Urb, Urb, Urb, Ur, Ur, Wwb, Wwb, Ur, Urb, Urb, Brym, Brym, Brym, Brym, Brym
Ur, Ur, Wwb, Wwb, Wwb, Ur, Ur, Ur, Urb, Ur, Urb, Urb, Urb, Ur, Urb, Urb, Brym, Brym, Brym, Brym, Urb, Urb, Ur, Ur, Wwb, Urb, Urb, Urb, Urb, Ur, Ur, Wwb, Wwb, Wwb, Btyb, Urb, Btyb, Brym, Brym, Brym, Brym, Brym
Ur, Wwb, Wwb, Wwb, Ur, Ur, Ur, Urb, Urb, Ur, Brym, Brym, Brym, Urb, Brym, Brym, Brym, Brym, Brym, Brym, Urb, Urb, Wwb, Wwb, Urb, Urb, Brym, Urb, Urb, Ur, Ur, Wwb, Btyb, Btyb, Btym, Brym, Btym, Brym, Brym, Btyb, Brym, Brym
Urb, Ur, Urb, Btyb, Btyb^Bryb, Btyb, Btyb, Btyb, Btyb, Urb, Brym, Brym, Brym, Brym, Brym, Brym, Btyb, Brym, Brym, Brym, Brym, Urb, Wwb, Wwb, Urb, Urb, Brym, Brym, Btyb, Urb, Btyb, Btyb, Btym, Btym, Btym, Btym^Sy|, Btym, Btym^Sy|, Btym, Btym, Btyb, Brym
Brym, Btyb^Bryb, Urb, Btym, Btym, Btym, Btym, Btym, Btym, Urb, Btyb, Btyb, Brym, Brym, Brym, Btyb, Btym, Btyb^Bryb, Brym, Brym, Brym, Urb, Urb, Urb, Brym, Urb, Brym, Brym, Btym, Brym, Btym, Btym, Btym, Btym, Btym, Btym^Sy|, Btym, Btym^Sy|, Btym, Btym, Btym, Btyb
Btym, Btym, Brym, Btym, Btym, Btym, Btym, Btym, Btym, Brym, Btym, Btym, Btym^Sy|, Brym, Btym, Btym, Btym, Btym, Btym, Brym, Brym, Brym, Btyb, Brym, Brym, Brym, Brym, Brym, Btym, Btym, Btym, Btym, Btym, Btym, Brym^Bryl, Brym, Brym, Brym, Brym, Btym, Btym, Btym
Btym, Btym, Btym^Sy|, Btym, Btym, Btym, Btym, Btym, Btym, Btym^Sy|, Btym, Btym, Btym^Sy|, Btym, Btym, Btym, Btym, Btym, Btym, Btym, Btym, Brym, Btym, Brym, Brym, Brym, Brym, Brym, Btym, Btym, Btym, Btym, Brym, Brym, Brym, Brym, Brym, Brym, Brym, Brym, Brym^Bryl, Btym
Btym, Btym, Btym^Sy|, Btym, Btym, Btym, Btym, Btym, Btym, Btym^Sy|, Btym, Btym, Brym, Btym, Brym, Btym, Brym^Bryl, Btym, Brym^Bryl, Btym, Btym, Btym, Btym, Btym, Btym, Btym, Btym, Btym, Btym, Btym, Btym, Brym^Bryl, Brym, Brym, Brym, Brym, Brym, Brym, Brym, Brym^Vymb, Brym, Brym
Brym^Bryl, Btym, Brym, Brym, Brym, Brym^Bryl, Brym, Brym^Bryl, Brym, Brym, Brym^Vymb, Brym, Brym, Brym, Brym, Brym, Brym, Brym^Vymb, Brym, Brym, Brym^Bryl, Btym, Btym, Btym, Btym, Btym, Btym, Btym, Brym, Brym, Brym, Brym, Brym, Brym, Brym, Brym, Brym, Brym, Brym, Brym, Brym, Brym
Brym, Brym, Brym, Brym, Brym, Brym, Brym, Brym, Brym, Brym, Brym, Brym, Brym, Brym, Brym^Vymb, Brym, Brym, Brym, Brym, Brym, Brym, Btym, Btym, Btym, Btym, Btym, Btym, Btym, Brym^Bryl, Brym, Brym, Brym^Vymb, Brym, Brym, Brym, Brym, Brym^Vymb, Brym, Brym, Brym, Brym^Bryl, Brym
Brym, Brym, Brym, Brym^Vymb, Brym, Brym, Brym, Brym, Brym, Brym, Brym, Brym, Brym, Brym, Brym, Brym, Brym, Brym, Brym, Brym, Brym, Btym, Btym, Btym, Btym, Btym, Btym, Btym, Brym, Brym, Brym, Brym, Brym, Brym, Brym, Brym, Brym, Brym, Brym, Brym, Brym, Brym
