Brym, Btym, Btym, Btym, Btym, Btym, Btym, Btym, Btym, Btym, Brym, Brym, Brym, Brym, Brym^Bryl, Brym, Brym, Brym, Brym, Brym, Brym, Brym, Kmy^Xo, Brym, Cmy, Cmy, Cmy
Brym, Btym, Btym, Btym, Btym, Btym, Btym, Btym, Brym, Brym, Brym, Brym^Vymb, Brym, Brym, Brym, Brym, Brym, Brym, Brym^Vymb, Brym, Brym, Brym, Cmy^Xo, Brym^Vymb, Cmy, Kmy, Cmy
Brym, Btym, Btym, Btym, Btym, Btym, Brym, Brym, Cmy, Cmy, Cmy, Brym, Brym, Brym, Brym^Fynt, Brym, Brym, Brym, Brym, Brym, Brym, Brym, Cmy^Xo, Brym, Brym, Cmy, Cmy
Brym, Btym, Btym, Btym, Brym, Brym, Brym, Brym, Cmy, Kmy, Cmy, Brym, Brym, Brym, Brym, Brym, Btyb, Brym, Brym, Brym, Brym, Brym, Brym, Cmy^Xo, Cmy^Xo, Brym^Vymb, Brym
Brym, Brym, Brym, Brym, Brym^Vymb, Brym, Brym, Brym, Brym, Cmy, Brym, Brym, Btyb, Brym, Brym, Brym, Btym, Brym, Btyb, Brym, Btyb, Brym, Btyb, Brym, Brym, Cmy^Xo, Kmy^Xo
Brym, Brym, Brym, Brym, Brym, Brym, Brym, Brym, Btyb, Brym, Brym, Brym, Btym, Brym, Brym^Vymb, Brym, Btym, Brym, Btym, Btyb, Btym, Brym, Btym, Brym, Brym, Brym, Brym
Btym, Brym, Btym, Brym, Brym, Btyb, Brym^Bryl, Brym, Btym, Brym, Brym^Lymp, Brym, Btym, Brym, Brym^Lymp, Brym, Btym, Btym, Btym, Btym, Btym, Btym, Btym, Btym, Btym, Brym^Bryl, Brym
Btym, Btym, Btym, Btym, Btym, Btym, Btym, Btym, Btym, Btym, Btym, Brym^Sy|, Btym, Btym, Btym, Btym, Btym, Btym, Btym, Btym, Btym, Btym, Btym, Btym, Btym, Btym, Btym
Brym, Btym, Brym, Btym, Btym, Btym, Btym, Btym, Btym, Btym, Btym, Brym^Sy|, Btym, Btym, Btym, Btym, Brym^Lymp, Brym, Btyb, Btym, Btyb, Brym, Brym, Brym^Bryl, Brym, Btym, Btym
Brym, Brym, Brym, Brym, Brym, Btym, Brym, Brym^Bryl, Brym^Vymb, Brym, Brym, Brym, Brym, Brym^Bryl, Brym, Brym, Brym, Brym, Btym, Brym^Bryl, Btym, Brym, Brym, Brym, Brym, Brym, Brym
Brym, Brym, Brym, Brym, Brym, Brym, Brym, Brym, Brym, Brym, Brym, Brym, Brym, Brym, Brym, Brym^Vymb, Brym, Brym, Btym, Cmy, Btym, Brym, Brym, Brym^Vymb, Brym, Brym, Brym
Brym, Brym, Brym, Brym, Brym, Brym, Cmy, Cmy, Cmy, Brym, Brym, Brym, Brym, Cmy, Cmy, Brym, Brym, Brym, Brym, Btym^Sy|, Brym, Brym, Brym, Brym, Brym, Brym, Brym
Brym, Brym, Brym, Brym, Brym, Brym, Cmy, Kmy, Cmy, Brym, Brym, Brym^Vymb, Brym, Cmy, Brym, Brym, Brym, Brym, Brym, Btym^Sy|, Brym, Brym, Brym, Brym, Brym, Brym, Btyb^Bryl
Brym, Brym, Brym, Brym^Vymb, Brym, Brym, Brym, Cmy, Brym, Brym, Brym, Brym, Brym, Brym, Brym, Brym, Btyb, Brym, Cmy, Brym, Brym^Lymp, Btyb^Bryl, Brym^Bryl, Cmy, Brym^Sy|, Brym, Btym
Brym, Brym, Brym, Brym, Brym, Brym, Brym, Brym, Brym, Brym, Brym, Brym, Btyb, Brym, Cmy, Brym, Btym, Brym, Btym, Cmy, Btym, Btym, Btym, Btym, Brym^Sy|, Btym, Btym
Brym, Brym, Brym, Brym, Brym, Brym, Brym, Brym^Vymb, Brym, Brym, Cmy, Brym, Btym, Brym^Bryl, Btym, Brym^Sy|, Btym, Btym, Btym, Btym, Btym, Btym, Btym, Btym, Brym, Btym, Btym
Brym, Btyb^Bryl, Brym, Brym, Brym, Btyb, Brym, Brym, Cmy, Brym^Lymp, Btym, Btym, Btym, Btym, Btym, Brym^Sy|, Btym, Btym, Brym^Vymb, Btym, Brym^Bryl, Btym, Brym, Brym, Brym, Brym, Brym
Brym, Btym, Brym, Brym, Brym, Btym, Brym, Cmy, Btym, Btym, Btym, Btym, Btym, Btym, Brym, Brym^Vymb, Brym, Brym, Brym, Brym, Brym, Brym, Brym, Brym, Brym, Brym, Brym
Brym, Btym, Btym, Brym^Lymp, Btym, Btym, Btym, Btym, Btym, Btym, Brym, Brym^Vymb, Brym, Brym, Brym, Brym, Brym, Brym, Brym, Brym, Brym, Brym, Brym, Brym^Vymb, Brym^Bryl, Brym, Brym
Brym, Btym, Btym, Btym, Btym, Btym, Btym, Btym, Brym^Bryl, Brym, Brym, Brym, Brym, Brym, Btyb, Btyb, Btyb, Brym, Cmy, Cmy, Cmy, Brym, Brym, Brym, Brym, Brym, Brym
Brym, Btym, Brym, Btym, Brym^Bryl, Btym, Brym, Brym, Brym, Brym, Cmy, Brym, Brym, Brym, Btym, Btym, Btym, Brym, Cmy, 1 Kmy, Cmy, Brym, Brym, Brym, Brym, Brym^Vymb, Brym
Brym, Brym, Brym^Vymb, Brym, Brym, Brym, Brym, Brym, Cmy, 2 Kmy, Cmy, Brym, Brym, Brym, Btym, Cmy, Btym, Brym, Brym, Cmy, Brym, Brym, Brym, Brym, Brym, Brym, Brym
Brym, Brym, Brym, Brym, Brym, Brym, Brym, Brym, Brym, Cmy, Brym, Brym, Brym^Vymb, Brym, Brym, Btym^Sy|, Brym, Brym, Brym, Brym, Brym, Brym, Brym, Brym^Vymb, Brym, Brym, Brym
Brym, Brym^Bryl, Brym, Brym, Brym, Brym^Vymb, Brym, Brym, Brym, Brym, Brym, Brym, Brym, Brym, Brym, Btym^Sy|, Brym, Brym, Brym, Brym, Brym, Brym, Brym, Brym, Brym, Brym, Brym
Cmy, Brym, Brym, Brym, Kmy, Brym, Brym, Brym, Brym, Brym, Brym, Brym, Brym, Brym, Brym, Brym, Brym, Brym, Brym, Brym, Brym, Brym, Kmy, Brym^Bryl, Brym, Brym, Cmy
Btym, Cmy, Kmy, Cmy, Cmy, Cmy, Kmy, Cmy, Cmy, Cmy, Brym^Bryl, Btyb, Brym, Btyb, Brym, Btyb, Brym^Bryl, Cmy, Cmy, Cmy, Kmy, Cmy, Cmy, Cmy, Kmy, Cmy, Btym
Btym, Btym, Btym, Btym, Btym, Btym, Btym, Btym, Btym, Btym, Btym, Btym, Btym^Sy|, Btym, Btym^Sy|, Btym, Btym, Btym, Btym, Btym, Btym, Btym, Btym, Btym, Btym, Btym, Btym
Rr, Btym, Btym, Btym, Btym, Btym, Btym, Btym, Btym, Btym, Btym, Btym, Btym^Sy|, Btym, Btym^Sy|, Btym, Btym, Btym, Btym, Btym, Btym, Btym, Btym, Btym, Btym, Btym, Rr
Hh, Rr, Rr, Rr, Rrc, Rrc, Rrc, Rrc, Rrc, Rrc, Cmy, Btym, Cmy, Btym, Cmy, Btym, Cmy, Rrc, Rrc, Rrc, Rrc, Rrc, Rrc, Rr, Rr, Rr, Hh
Hh, Hh, Hh^Edb, Hh, Hh, Hh, Hh, Rrc, Rrc^Edb, Rrc, Rrc, Cmy, Rrc, Cmy, Rrc, Cmy, Rrc, Rrc, Hh, Rrc, Rr, Hh, Hh, Hh, Hh^Es, Hh, Mm
Mm, Mm, Mm, Mm, Hh, Hh, Hh, Rrc^Edb, Rrc, Rrc^Es, Rrc^Edb, Rrc^Edb, Rrc, Rrc, Rrc^Edb, Rrc, Rrc^Edb, Hh, Mm, Hh, Hh^Es, Hh, Mm, Hh, Mm, Hh^Edb, Hh
Mm, Mm, Mm, Mm, Hh^Dr, Hh^Es, Hh, Hh, Hh^Edb, Rrc^Es, Rrc, Rrc^Edb, Rrc, Rrc^Edb, Rrc^Edb, Rrc^Edb, Hh, Hh, Mm, Hh^Es, Mm, Hh^Edb, Hh^Dr, Hh^Es, Mm, Mm, Hh
Mm, Hh, Mm, Mm, Hh^Dr, Mm, Mm, Hh^Es, Hh^Edb, Hh^Edb, Rr, Rrc, Rrc, Rrc^Edb, Rrc, Rrc^Edb, Hh, Hh^Es, Mm, Mm, Mm, Mm, Mm, Hh^Dr, Mm, Mm, Mm
Mm, Mm, Hh, Mm, Mm, Mm, Mm, Hh^Dr, Hh^Es, Hh, Hh, Rr, Rrc, Rrc, Rrc, Rrc, Rr, Hh^Es, Hh, Hh^Dr, Mm, Mm, Mm, Mm^Vud, Mm, Mm, Mm
Mm, Mm, Mm, Mm, Mm, Mm, Mm, Mm, Mm, Mm, Hh, Rr, Rr, Rrc, Rrc, Rrc, Rr, Mm, Mm, Mm, Mm, Mm, Mm, Mm, Mm, Mm, Mm
Mm, Mm, Mm, Mm, Uh^Vud, Mm, Mm, Mm, Hh, Hh^Edb, Hh^Edb, Hh, Mm, Rrc, Rrc, Rrc, Rrc, Mm, Mm, Mm, Mm, Mm^Vud, Mm, Mm, Mm^Vud, Mm, Mm
Mm, Mm^Vud, Mm, Mm, Cydy, Uh, Hhd^Es, Hhd^Es, Mm, Mm, Mm, Hh^Es, Mm, Mm, Rr, Rrc, Rrc, Rr, Rr, Mm, Uh, Mm, Cydy, Mm, Qlf, Mm, Mm
Mm^Xm, Mm, Qlf, Cydy, 3 Kydy, Cydy, Uh, Mm, Mm, Mm, Mm, Mm, Mm, Mm, Mm, Rrc, Rrc, Rrc, Rr, Hhd, Uh^Es, Cydy, 4 Kydy, Cydy, Qlf, Mm, Mm^Xm
Mm^Xm, Mm^Xm, Mv, Cydy, Cydy, Cydy, Uh, Uh^Vud, Mm, Mm, Mm, Mm, Mm, Mm, Mm, Mm, Rrc, Rrc, Rr, Mm, Mm, Cydy, Cydy, Cydy, Mv, Mm^Xm, Mm^Xm
Mm^Xm, Mm, Mm, Mm, Qlf, Qlf, Mm, Mm, Mm^Vud, Mm, Mm, Mm, Mm, Mm, Mm, Rr, Rr, Rr, Mm, Mm, Mm, Mm^Vud, Qlf, Mm, Mm, Mm, Mm^Xm
Mm^Xm, Mm^Xm, Mm^Xm, Qlf, Mm, Mm, Mm, Mm, Mm, Mm, Mm, Mm, Mm, Mm, Mm, Rr, Rr, Rr, Mm, Mm, Mm, Qlf, Mm, Mm^Xm, Mm^Xm, Mm, Mm^Xm
Mm^Xm, Mm^Xm, Mm^Xm, Mm, Mm, Mm, Mm, Mm, Mm, Mm, Mm, Mm, Mm, Mm, Mm, Rr, Rr, Rr, Hh, Mm, Mm, Mm^Xm, Mm^Xm, Mm^Xm, Mm^Xm, Mm^Xm, Mm
