border_size=1
usage=map

Wuy, Wuy, Wuy, Wuy, Wuy, Wuy, Wuy, Wuy, Wuy, Wuy, Wuy, Wuy, Wuy, Wuy, Wuy, Wuy, Wuy, Wuy, Wuy, Wuy, Wuy, Wuy, Wuy, Wuy, Wuy, Wuy, Wuy, Wuy, Wuy, Wuy, Wuy, Wuy, Wuy, Wuy, Wuy, Wuy, Wuy, Wuy, Wuy, Wuy, Wuy, Wuy, Wuy, Wuy, Wuy, Wuy, Wuy, Wuy, Wuyb, Wuyb, Wuyb, Wuy, Wuy, Wuy, Wuy, Wuy
Wuy, Wuy, Wuy, Wuy, Wuy, Wuy, Wuy, Wuy, Wuyb, Wuyb, Wuyb, Wuy, Wuy, Wuy, Wuy, Wuy, Wuy, Wuy, Wuy, Wuy, Wuy, Wuy, Wuy, Wuy, Wuy, Wuy, Wuy, Wuy, Wuy, Wuy, Wuyb, Wuyb, Wuyb, Wuy, Wuy, Wuy, Wuyb, Wuy, Wuyb, Wuy, Wuyb, Wuy, Wuy, Wuy, Wuyb, Wuyb, Wuyb, Wuyb, Wuyb, Wuyb, Wuyb, Wuyb, Wuyb, Wuy, Wuy, Wuy
Wuy, Wuy, Wuy, Wuy, Wuyb, Wuyb, Wuyb, Wuyb, Mybd, Mybd, Mybd, Wuyb, Wuyb, Wuyb, Wuyb, Wuyb, Wuyb, Wuyb, Wuyb, Wuyb, Wuyb, Wuyb, Wuyb, Wuyb, Wuyb, Wuyb, Wuyb, Wuyb, Wuyb, Wuyb, Wuyb, Wuyb, Wuyb, Wuyb, Wuyb, Wuyb, Woby, Wuyb, Woby, Wuyb, Woby, Wuyb, Wuyb, Wuyb, Woby, Woby, Woby, Woby, Woby, Gd, Woby, Wuyb, Wuyb, Wuy, Wuy, Wuy
Wuy, Wuy, Wuyb, Wuyb, Wuyb, Wuyb, Mybd, Mybd, Mybd, Mybd, Mybd, Mybd, Ur, Wuyb, Wuyb, Wuyb, Wuyb, Wuyb, Wuyb, Wuyb, Wuyb, Wuyb, Wuyb, Wuyb, Wuyb, Wuyb, Wuyb, Wuyb, Wuyb, Wuyb, Wuyb, Wuyb, Wuyb, Wuyb, Uue^Emf, Uh^Uf, Ur, Ur, Urb, Woby, Wuy, Wuy, Wuyb, Qlf, Woby, Woby, Wog, Woby, Woby, Woby, Woby, Wwby, Wuyb, Wuyb, Wuy, Wuy
Wuy, Wuyb, Wuyb, Wuyb, Woby, Wwby, Mybd, Mybd, Mybd, Gs^Fds, Mybd, Mybd, Mybd, Uu, Uue^Emf, Wuyb, Wuyb, Wuyb, Wuyb, Wuyb, Wuyb, Wuyb, Wuyb, Wuyb, Wuyb, Wuyb, Wuyb, Wuyb, Wuyb, Wuyb, Wuyb, Wuyb, Wuyb, Woby, Uue, Woby, Woby, Woby, Woby, Woby, Wuy, Wuyb, Wuyb, Woby, Woby, Wog, Wog^Zulf, Wog, Woby, Woby, Woby, Wwby, Mybd, Wuyb, Wuyb, Wuy
Wuy, Wuyb, Wuyb, Woby, Wwby, Mybd, Gd^Fyok, Mybd, Urb, Qlf, Urb, Mybd, Gll^Fmw, Mybd, Uue, Uh^Uf, Wuyb, Wuyb, Wuyb, Wuyb, Wuyb, Wuyb, Wuyb, Wuyb, Wuyb, Wuyb, Wuyb, Wuyb, Wuyb, Wuyb, Woby, Woby, Uu, Uh^Uf, Uue, Wuyb, Wuyb, Wuyb, Woby, Woby, Wuyb, Wuyb, Wuyb, Woby, Woby, Wog, Wog, Wog, Woby, Woby, Woby, Wwby, Wwby, Mybd, Wuyb, Wuyb
Wuy, Wuyb, Wuyb, Woby, Wwby, Mybd, Mybd, Qlf, Qlf, Qlf, Qlf, Qlf, Mybd, Ur, Ur, Uh, Wuyb, Wuyb, Wuyb, Wuyb, Wuyb, Wuyb, Wuyb, Wuyb, Wuyb, Wuyb, Wuyb, Wuyb, Wuyb, Wuyb, Mybd, Uu, Woby, Woby, Urb, Woby, Wuyb, Wuyb, Wuyb, Wuyb, Wuyb, Wuy, Wuyb, Woby, Woby, Woby, Woby, Woby, Woby, Woby, Wwby, Wwby, Wwby, Mybd, Wuyb, Wuyb
Wuyb, Wuyb, Wuyb, Woby, Wwby, Wwby, Mybd, Urb, Qlf, Xu, Qlf, Urb, Mybd, Ur, Uu, Uue^Emf, Uh^Uf, Wuyb, Wuyb, Wuyb, Wuyb, Wuyb, Mybd, Wuyb, Fypd, Wuyb, Tyb, Wuyb, Woby, Woby, Mybd, Wuyb, Wuyb, Woby, Woby, Woby, Wuyb, Wuyb, Wuyb, Wuyb, Wuyb, Wuyb, Wuyb, Wuyb, Wuyb, Woby, Urb, Woby, Woby, Wwby, Wuyb, Mybd, Mybd, Mybd, Wuyb, Wuy
Wuyb, Wuyb, Wuyb, Wwby, Fypd, Mybd, Gll^Fdw, Qlf, Urb, Qlf, Urb, Qlf, Gll^Fp, Mybd, Uu, Uue, Uue^Emf, Uh, Ur, Ur, Mybd, Mybd^Gyw, Wuyb, Fyp, Fypd, Tyb, Tyb, Mybd, Mybd, Woby, Mybd, Wuyb, Wuyb, Wuyb, Wuyb, Wuyb, Wuyb, Wuyb, Wuyb, Wuyb, Fyp^Fyod, Wuyb, Fypd, Wuyb, Wuyb, Wuyb, Wuyb, Wuyb, Wuyb, Wuyb, Wuyb, Mybd, Mybd, Tyb, Wuyb, Wuyb
Wuyb, Wuyb, Wuyb, Fyp, Fyp, Mybd, Mybd, Mybd, Mybd, Qlf, Mybd, Mybd, Mybd, Mybd, Mybd, Uu, Wuyb, Uu, Wuyb, Mybd, Wuyb, Wuyb, Fyp, Fyp, Fypd^Fypp, Tyb, Tyb, Tyb, Tyb, Mybd, Mybd, Mybd, Urfz^Gye, Wuyb, Wuyb, Wuyb, Wuyb, Wuyb, Fyp, Fypd, Fypd, Fypd, Fyp^Fypp, Fypd, Mybd^Pyg, Wuyb, Wuyb, Wuyb, Wuyb, Wuyb, Mybd, Mybd, Tyb, Tyb, Wuyb, Wuyb
Wuyb, Wuyb, Wuyb, Fyp, Fypd, Fypd, Fypd, Mybd, Mybd, Gg^Fet, Mybd, Mybd, Mybd, Mybd, Mybd, Wuyb, Wuyb, Wuyb, Wuyb, Wuyb, Wuyb, Wuyb, Fyp, Fypd, Fypd, Fypd^Fyod, Tyb, Wuyb, Wuyb, Wuyb, Wuyb, Mybd^Gye, Urfz, Mybd, Mybd, Mybd, Mybd, Mybd, Fyp, Fypd, Fypd, Fyp, Wuy, Fyp, Mybd^Pyg, Urfz, Urfz, Pryf, Urfz, Urfz, Mybd, Mybd, Tyb, Wuyb, Wuy, Wuy
Wuyb, Wuyb, Wuyb, Wuyb, Wuyb, Fypd, Fyp, Mybd, Uzw, Mybd, Uzw, Mybd, Wuyb, Mybd, Mybd, Mybd, Mybd^Gye, Wuyb, Qxu, Wuyb, Mybd, Mybd, Wuyb, Wuyb, Fyp, Fyp, Wuyb, Wuyb, Wuyb, Wuyb, Wuyb, Wuyb, Urfz^Gyw, Urfz, Wuyb, Wuyb, Wuyb, Uzw, Uzw, Fyp, Wuy, Wuy, Wuy, Wuy, Wuy, Urfz, Wuy, Urfz, Wuy, Urfz, Wuy, Tyb, Wuy, Wuy, Wuy, Wuy
Wuyb, Wuyb, Wuyb, Wuyb, Wuyb, Wuyb, Wuyb, Mybd, Uzw, Wuyb, Wuyb, Wuyb, Wuyb, Wuyb, Mybd, Mybd, Wuy, Mybd, Wuy, Qxu, Qxu, Wuyb, Wuyb, Wuyb, Mybd, Wuyb, Wuyb, Wuyb, Wuyb, Wuyb, Wuyb, Mybd, Urfz, Wuyb, Wuyb, Wuy, Wuyb, Wuyb, Uzw, Fyp, Wuy, Wuy, Wuy, Wuy, Wuy, Wuy, Wuy, Wuy, Wuy, Wuy, Wuy, Wuy, Wuy, Wuy, Wuy, Wuy
Wuyb, Wuyb, Wuyb, Wuyb, Wuyb, Wuyb, Wuyb, Mybd, Mybd, Wuyb, Wuyb, Wuyb, Wuyb, Wuyb, Mybd, Wuy, Wuy, Wuy, Wuy, Qxu, Wuyb, Wuyb, Wuyb, Mybd, Wuyb, Wuyb, Wuyb, Wuyb, Uzw, Wuyb, Uzw, Mybd, Uzw, Urfz, Wuy, Wuyb, Wuyb, Qxv, Uzw, Mybd, Wuy, Wuy, Fypd, Fypd^Ayb, Fyp, Wuy, Fypd, Wuy, Wuy, Wuy, Wuy, Wuy, Wuy, Wuy, Wuy, Wuy
Wuyb, Wuyb, Wuyb, Wuyb, Wuyb, Wuyb, Wuyb, Mybd, Mybd, Uzw, Urfz, Uzw, Mybd, Urfz, Urfz, Wuy, Wuy, Wuy, Wuy, Qxu, Wuyb, Wuyb, Urfz, Mybd, Wuyb, Wuyb, Qxv, Qxv, Qxv^Fyb/, Fypd, Uzw, Mybd, Uzw, Wuy, Wuy, Wuy, Wuy, Qxv, Mybd, Mybd, Mybd, Wuy, Fypd, Mybd^Fyod, Fyp, Fypd, Wuy, Wuy, Wuy, Woby, Urb, Wuy, Wuy, Wuy, Wuy, Wuy
Wuyb, Wuyb, Wuyb, Woby, Woby, Woby, Mybd, Mybd, Wuy, Wuy, Wuy, Urfz, Wuy, Urfz, Wuy, Wuy, Wuy, Wuy, Wuy, Urfz, Urfz, Wuyb, Urfz, Wuyb, Wuyb, Wuyb, Fypd, Qxv^Fyb/, Qxv, Uzw, Wuyb, Uzw, Uzw, Wuy, Wuy, Wuy, Wuy, Wuy, Urfz^Gyw, Urfz, Urfz, Urfz, Mybd, Fyp, Mybd, Wuy, Wuy, Wuy, Woby, Woby, Woby, Woby, Wuy, Wuy, Wuy, Wuy
Wuy, Wuyb, Wuy, Woby, Mybd, Mybd, Fyp, Mybd, Wuy, Wuy, Wuy, Wuy, Wuy, Mybd, Wuy, Wuy, Wuy, Wuy, Mybd, Mybd, Urfz, Urfz, Mybd, Wuyb, Wuyb, Uzw, Uzw, Qxv, Wuyb, Wuyb, Wuyb, Wuyb, Mybd, Wuy, Mybd, Wuy, Wuy, Mybd, Wuy, Wuy, Wuy, Urfz, Wuy, Mybd, Mybd, Wuy, Wuy, Fypd, Woby, Woby, Wuy, Wuy, Wuy, Wuy, Wuy, Wuy
Wuy, Wuy, Wuy, Woby, Woby, Fypd, Fyp, Fypd, Tyb, Wuy, Tyb, Wuy, Tyb, Tyb, Mybd, Wuy, Mybd, Wuy, Mybd^Gyw, Mybd, Mybd, Mybd, Mybd, Wuyb, Wuyb, Uzw, Fyp, Wuyb, Wuyb, Wuyb, Wuyb, Mybd, Mybd, Mybd, Mybd, Mybd, Tyb, Mybd, Mybd, Wuy, Wuy, Wuy, Wuy, Urfz, Mybd, Wuy, Wuy, Woby, Woby, Wuy, Wuy, Wuy, Wuy, Wuy, Wuy, Wuy
Wuy, Wuy, Wuy, Wuy, Woby, Fypd^Fyod, Mybd, Mybd, Fypd, Tyb, Fypd, Fypd, Tyb, Mybd, Woby, Mybd, Woby, Mybd, Mybd, Mybd^Gyw, Wuy, Mybd, Fyp, Wuyb, Wuyb, Fyp, Fyp, Wuyb, Wuyb, Wuyb, Urfz, Urfz, Wuy, Wuy, Wuy, Mybd, Wuy, Tyb, Mybd, Wuy, Wuy, Wuy, Wuy, Mybd, Mybd, Wuy, Wuy, Mybd, Woby, Wuy, Wuy, Woby, Wuy, Wuy, Wuy, Wuy
Wuy, Wuy, Wuy, Wuy, Wuy, Fypd, Mybd, Fyp, Wuy, Wuy, Wuy, Fypd, Wuy, Mybd, Mybd, Woby, Woby, Mybd, Wuy, Wuy, Wuy, Wuy, Wuy, Fypd, Fypd, Fypd, Fyp, Wuyb, Urfz, Urfz, Pryf, Urfz, Urfz, Wuy, Wuy, Wuy, Wuy, Tyb, Woby, Wuy, Wuy, Wuy, Wuy, Tyb, Tyb, Mybd, Mybd, Mybd, Fyp, Wuy, Fyp, Woby, Woby, Wuy, Wuy, Wuy
Wuy, Wuy, Wuy, Wuy, Wuy, Wuy, Wuy, Fyp^Gye, Fypd, Wuy, Wuy, Wuy, Wuy, Wuy, Mybd, Woby, Woby, Woby, Wuy, Wuy, Wuy, Wuy, Wuy, Wuy, Fypd, Fyp, Uzw, Uzw, Urfz, Urfz, Urfz, Urfz, Fypd^Fypp, Wuy, Wuy, Wuy, Wuy, Wuy, Woby, Wuy, Wuy, Wuy, Wuy, Tyb, Mybd, Mybd, Woby, Mybd, Woby, Fyp, Woby, Woby, Wuy, Wuy, Wuy, Wuy
Wuy, Wuy, Wuy, Wuy, Wuy, Wuy, Wuy, Fyp, Tyb, Wuy, Wuy, Wuy, Wuy, Wuy, Wuy, Mybd, Mybd, Woby, Woby, Wuy, Wuy, Wuy, Wuy, Wuy, Mybd, Wuy, Wuy, Wuy, Wuy, Wuy, Wuy, Urfz, Uzw, Uzw, Mybd, Woby, Woby, Woby, Wuy, Wuy, Wuy, Wuy, Wuy, Tyb, Wuy, Woby, Woby, Woby, Wuy, Wuy, Wuy, Woby, Wuy, Wuy, Wuy, Wuy
Wuy, Wuy, Wuy, Wuy, Wuy, Wuy, Wuy, Wuy, Pryf, Wuy, Wuy, Wuy, Wuy, Wuy, Wuy, Wuy, Wuy, Urb, Wuy, Wuy, Wuy, Wuy, Wuy, Wuy, Wuy, Mybd, Wuy, Wuy, Wuy, Wuy, Wuy, Uzw, Wuy, Uzw, Mybd, Woby, Wuy, Wuy, Wuy, Wuy, Wuy, Wuy, Wuy, Wuy, Wuy, Wuy, Woby, Woby, Woby, Wuy, Wuy, Wuy, Wuy, Wuy, Wuy, Wuy
Wuy, Wuy, Wuy, Wuy, Wuy, Wuy, Wuy, Wuy, Pryf, Fypd, Wuy, Wuy, Wuy, Wuy, Wuy, Wuy, Wuy, Woby, Woby, Wuy, Wuy, Wuy, Wuy, Wuy, Wuy, Mybd, Wuy, Wuy, Wuy, Wuy, Wuy, Wuy, Wuy, Wuy, Wuy, Wuy, Wuy, Wuy, Wuy, Wuy, Woby^Xo, Wuy, Woby^Xo, Wuy, Woby, Wuy, Woby, Woby, Woby, Woby, Woby, Wuy, Woby^Xo, Wuy, Wuy, Wuy
Wuy, Wuy, Wuy, Wuy, Wuy, Wuy, Wuy, Wuy, Tyb, Tyb, Tyb, Wuy, Wuy, Wuy, Wuy, Wuy, Wuy, Wuy, Wuy, Wuy, Wuy, Wuy, Wuy, Wuy, Wuy, Mybd, Wuy, Wuy, Wuy, Wuy, Wuy, Wuy, Wuy, Wuy, Wuy, Wuy, Woby^Xo, Wuy, Woby^Xo, Woby^Xo, Woby^Xo, Woby^Xo, Woby^Xo, Woby, Woby, Woby, Woby, Woby, Woby, Woby, Woby, Woby, Woby^Xo, Woby^Xo, Woby^Xo, Wuy
Wuy, Wuy, Wuy, Wuy, Wuy, Wuy, Wuy, Wuy, Wuy, Mybd, Mybd, Mybd, Woby, Wuy, Wuy, Wuy, Wuy, Wuy, Wuy, Wuy, Wuy, Wuy, Wuy, Wuy, Wuy, Mybd, Wuy, Wuy, Wuy, Wuy, Wuy, Wuy, Wuy, Wuy, Woby^Xo, Woby^Xo, Woby^Xo, Woby^Xo, Woby^Xo, Woby^Xo, Woby, Woby^Xo, Woby, Woby, Woby, Woby, Woby, Woby, Woby, Woby, Woby, Woby, Qxv, Woby^Xo, Woby^Xo, Woby^Xo
Wuy, Wuy, Wuy, Wuy, Woby, Wuy, Wuy, Wuy, Woby, Woby, Woby, Woby, Woby, Wuy, Wuy, Wuy, Wuy, Wuy, Wuy, Wuy, Wuy, Wuy, Wuy, Wuy, Qxv, Aa, Aa, Qxv, Qxv, Wuy, Wuy, Wuy, Wuy, Woby^Xo, Woby^Xo, Woby^Xo, Qxv, Woby^Xo, Woby, Woby, Qxua, Woby, Woby, Woby, Woby, Woby, Woby, Woby, Woby, Woby, Woby, Woby, Woby, Qxv, Woby^Xo, Woby^Xo
Wuy, Wuy, Woby, Woby, Woby, Woby, Woby, Woby, Woby, Woby, Woby, Woby, Woby, Woby, Woby, Wuy, Wuy, Wuy, Wuy, Wuy, Wuy, Wuy, Wuy, Gll^Fetd, Qxv, Qxv, Aa, Qxv, Qxv, Ww, Wuy, Wuy, Wuy, Woby^Xo, Woby^Xo, Qxv^Xo, Qxv, Woby, Woby, Qxua, Woby, Woby, Woby, Woby, Woby, Woby, Woby, Woby, Woby, Woby, Woby, Woby, Woby, Woby, Woby^Xo, Woby^Xo
Wuy, Wuy, Woby, Woby, Woby, Woby, Woby, Woby, Woby, Woby, Woby, Woby, Woby, Woby, Woby, Woby, Woby, Wuy, Wuy, Wuy, Wuy, Wuy, Wuy, Qxv, Qxv, Aa, Ayb, Aa, Qxv, Qxv, Wuy, Wuy, Wuy, Woby^Xo, Woby^Xo, Qxv^Xo, Xu, Woby, Woby, Woby, Woby, Woby, Woby, Woby, Wwby, Wwby, Wwby, Woby, Woby, Woby, Woby, Woby, Woby, Woby, Woby^Xo, Woby^Xo
Woby, Woby, Woby, Woby, Woby, Woby, Woby, Woby, Woby, Woby, Woby, Woby, Woby, Woby, Woby, Woby, Woby, Woby, Wuy, Wuy, Wuy, Wuy, Wuy, Qxv, Qxv, Aa, Aa, Aa, Qxv, Qxv, Wuy, Wuy, Wuy, Woby^Xo, Woby^Xo, Woby^Xo, Xu, Xu, Qxua, Woby, Woby, Woby, Woby, Wwby, Ayb, Ayb, Ayb, Wwby, Woby, Woby, Woby, Woby, Woby, Woby, Woby^Xo, Woby^Xo
Woby, Woby, Woby, Woby, Woby, Woby, Woby, Woby, Woby, Woby, Woby, Woby, Woby, Woby, Woby, Woby, Woby, Woby, Wuy, Wuy, Wuy, Wuy, Wuy, Qxv, Qxv, Qxv, Qxv, Qxv, Qxv, Qxv, Wuy, Wuy, Wuy, Woby^Xo, Woby^Xo, Woby^Xo, Xu, Qxua, Woby, Woby, Woby, Woby, Woby, Wwby, Ayb, Kpy, Ayb, Wwby, Woby, Woby, Woby, Woby, Qxua, Woby, Woby^Xo, Woby^Xo
Woby, Woby, Woby, Woby, Woby, Woby, Woby, Woby, Wwby, Wwby, Wwby, Woby, Woby, Woby, Woby, Woby, Woby, Woby, Wuy, Wuy, Wuy, Wuy, Wuy, Rb^Ecf, Qxv, Qxv, Qxv, Qxv, Qxv, Wwb^Ii, Wuy, Wuy, Wuy, Wuy, Woby^Xo, Woby^Xo, Xu, Qxua, Woby, Woby, Woby, Woby, Woby, Wwby, Wwby, Ayb, Wwby, Wwby, Woby, Woby, Woby, Woby, Woby, Woby, Xu, Woby^Xo
Woby, Woby, Woby, Woby, Woby, Woby, Woby, Wwby, Ayb, Ayb, Ayb, Wwby, Woby, Woby, Woby, Woby, Woby, Wuy, Wuy, Wuy, Wuy, Wuy, Wuy, Wuy, Wuy, Wuy, Wuy, Wuy, Wuy, Wuy, Wuy, Wuy, Wuy, Wuy, Woby^Xo, Woby^Xo, Woby^Xo, Xu, Woby, Woby, Woby, Woby, Woby, Woby, Woby, Wwby, Woby, Woby, Woby, Woby, Woby, Woby, Woby, Woby, Xu, Woby^Xo
Woby, Woby, Woby, Woby, Woby, Woby, Woby, Wwby, Ayb, Kpy, Ayb, Wwby, Woby, Woby, Woby, Woby, Woby, Woby, Wuy, Wuy, Wuy, Wuy, Wuy, Wuy, Wuy, Wuy, Wuy, Wuy, Wuy, Wuy, Wuy, Wuy, Wuy, Wuy, Woby^Xo, Woby^Xo, Woby^Xo, Xu, Woby, Woby, Woby, Woby, Woby, Woby, Woby, Woby, Woby, Woby, Woby, Woby, Woby, Woby, Xu, Xu, Woby^Xo, Woby^Xo
Woby, Woby, Woby, Woby, Woby, Woby, Woby, Wwby, Wwby, Ayb, Wwby, Wwby, Woby, Woby, Woby, Woby, Woby, Woby, Woby, Wuy, Wuy, Wuy, Wuy, Wuy, Wuy, Wuy, Wuy, Wuy, Wuy, Wuy, Wuy, Wuy, Wuy, Wuy, Wuy, Woby^Xo, Woby^Xo, Woby, Woby, Qxua, Qxua, Woby, Woby, Woby, Woby, Woby, Qxua, Woby, Woby, Woby, Qxua, Qxua, Xu, Xu, Woby^Xo, Woby^Xo
Woby, Woby, Woby, Woby, Woby, Woby, Woby, Woby, Woby, Wwby, Woby, Woby, Woby, Woby, Woby, Woby, Woby, Woby, Woby, Woby, Woby, Wuy, Wuy, Wuy, Wuy, Wuy, Wuy, Wuy, Wuy, Wuy, Wuy, Wuy, Wuy, Wuy, Wuy, Woby^Xo, Woby^Xo, Woby^Xo, Woby^Xo, Woby, Woby, Woby, Woby, Woby, Woby, Woby, Woby, Woby, Woby, Woby, Xu, Xu, Xu, Xu, Woby^Xo, Woby^Xo
Woby, Woby, Woby, Woby, Woby, Woby, Woby, Woby, Woby, Woby, Woby, Woby, Woby, Woby, Woby, Woby, Woby, Woby, Woby, Woby, Woby, Woby, Wuy, Wuy, Wuy, Wuy, Wuy, Wuy, Wuy, Wuy, Wuy, Wuy, Wuy, Wuy, Wuy, Woby^Xo, Woby^Xo, Woby^Xo, Woby^Xo, Woby^Xo, Woby^Xo, Woby, Woby, Woby, Woby, Woby, Woby, Woby, Woby, Woby, Xu, Xu, Woby^Xo, Woby^Xo, Woby^Xo, Woby^Xo
Woby, Woby, Woby, Woby, Woby, Woby, Woby, Woby, Woby, Woby, Woby, Woby, Woby, Woby, Woby, Woby, Woby, Woby, Woby, Woby, Woby, Woby, Wuy, Wuy, Wuy, Wuy, Wuy, Wuy, Wuy, Wuy, Wuy, Wuy, Wuy, Wuy, Wuy, Wuy, Wuy, Wuy, Wuy, Woby^Xo, Woby^Xo, Woby^Xo, Woby^Xo, Woby, Woby^Xo, Woby^Xo, Woby^Xo, Woby^Xo, Woby^Xo, Woby^Xo, Woby^Xo, Woby^Xo, Woby^Xo, Woby^Xo, Woby^Xo, Woby^Xo
Woby, Woby, Woby, Woby, Woby, Woby, Woby, Woby, Woby, Woby, Woby, Woby, Woby, Woby, Woby, Woby, Woby, Woby, Woby, Woby, Woby, Woby, Wuy, Wuy, Wuy, Wuy, Wuy, Wuy, Wuy, Wuy, Wuy, Wuy, Wuy, Wuy, Wuy, Wuy, Wuy, Wuy, Wuy, Woby^Xo, Woby^Xo, Woby^Xo, Woby^Xo, Woby^Xo, Woby^Xo, Woby^Xo, Woby^Xo, Woby^Xo, Woby^Xo, Woby^Xo, Woby^Xo, Woby^Xo, Woby^Xo, Woby^Xo, Woby^Xo, Woby^Xo
