border_size=1
usage=map

Brym, Btym, Btym, Btym, Btym, Btym, Btym, Brym, Brym, Brym, Brym, Brym, Btym, Btym, Btym, Btym, Btym, Btym, Btym, Btym, Btym, Btym, Btym, Btym, Btym, Brym, Brym, Brym, Btym, Btym, Btym, Brym, Xomy, Xomy, Xomy, Xomy, Xomy, Xomy, Xomy, Xomy, Xomy, Xomy, Xomy, Xomy, Xomy
Btym, Btym, Btym, Btym, Btym, Btym, Btym, Btyb, Btyb, Brym, Brym, Brym, Brym^Bryb, Btym, Btym, Btym, Btym, Btym, Btym^Bydc, Btym, Btym, Btym, Btym, Btym, Brym^Bryb, Brym, Brym, Brym, Btym, Btym, Btym, Brym, Brym, Xomy, Xomy, Xomy, Xomy, Xomy, Brym, Brym, Brym, Xomy, Xomy, Xomy, Xomy
Brym, Btym, Btym, Btym, Btym, Btym, Btym, Btym, Btym, Brym, Brym, Btyb, Brym, Brym, Brym, Btym, Btym, Btym, Brym, Btym, Btym, Btym, Brym, Brym, Btyb, Btyb, Btyb, Brym, Btym, Btym, Btym, Brym, Brym, Xomy, Xomy, Xomy, Xomy, Brym, Brym, Brym, Brym, Brym, Xomy, Xomy, Xomy
Gg^Fp, Btym, Btym, Gg^Efm, Gg^Efm, Btym, Btym, Btym, Btym, Brym, Brym, Btym, Brym, Btyb, Brym, Brym, Brym^Bryb, Cmy, Cmy, Cmy, Brym^Bryb, Brym, Brym, Brym, Btym, Btym, Btym, Brym, Btym, Btym, Btym, Brym, Brym, Xomy, Xomy, Xomy, Xomy, Brym, Brym, Brym, Brym, Brym, Xomy, Xomy, Xomy
Gg^Fmf, Gg^Fds, Gg, Gg, Gg^Fp, Gg, Btym, Btym, Btym, Btym, Btym, Btym, Brym^Bryl, Btym, Cmy, Brym, Brym, Brym, Brym, Brym, Brym, Brym, Cmy, Brym^Bryl, Btym, Btym, Btym, Brym, Btym, Btym, Btym, Brym^Bryl, Brym, Brym, Xomy, Xomy, Xomy, Brym, Brym, Brym, Brym, Brym, Xomy, Xomy, Xomy
Gg, Gg, Gg^Efm, Gg, Gg^Fms, Gg, Gg, Btym, Btym, Btym, Btym, Btym, Btym, Btym, Btym, Cmy, Brym^Bryl, Brym, Btym^Sy|, Brym, Brym^Bryl, Cmy, Btym, Btym, Btym, Btym, Btym, Btym, Btym, Btym, Btym, Brym, Btyb, Brym, Brym, Xomy, Xomy, Xomy, Xomy, Brym, Xomy, Xomy, Xomy, Xomy, Xomy
Gg, Gg^Efm, Gg^Fmf, Gg, Gg, Gg, Gg, Gg^Efm, Gg^Fms, Gg^Fmf, Gg^Fp, Btym, Btym, Btym, Btym, Btym, Btym, Btym, Btym^Sy|, Btym, Btym, Btym, Btym, Btym, Btym, Btym, Btym, Btym, Brym, Brym, Brym, Brym, Btym, Brym, Brym^Vymb, Brym, Xomy, Xomy, Xomy, Brym, Xomy, Xomy, Xomy, Xomy, Xomy
Gg^Fp, Gg, Gg, Gg, Gg, Gg, Gg, Gg, Gg, Gg, Gg, Gg, Brym^Bryl, Brym, Brym, Btym, Btym, Btym, Cmy, Btym, Btym, Btym, Brym, Brym, Brym, Brym^Bryl, Brym, Brym, Brym, Brym^Vymb, Brym, Brym, Btym, Brym, Btyb, Brym, Brym, Xomy, Xomy, Brym, Xomy, Xomy, Xomy, Xomy, Xomy
Gg^Fmf, Gg^Fds, Gg, Gg, Wwt^Vyth, Gg, Wwt^Vyth, Gg, Gg, Gg^Fds, Gg^Fms, Gg, Cmy^Xo, Brym, Brym, Brym, Brym, Cmy, Cmy, Cmy, Brym, Brym, Brym, Brym, Brym^Vymb, Brym, Brym, Brym, Brym, Brym, Brym, Brym, Brym, Brym, Btym, Btyb, Brym, Xomy, Brym, Brym, Xomy, Xomy, Xomy, Xomy, Xomy
Gg, Gg, Gg, Gg, Wwt^Vyth, Wwt^Vyth, Wwt^Vyth, Gg, Gg, Gg^Fp, Gg, Gg, Cmy^Xo, Brym, Brym, Brym, Brym, Brym, Brym, Brym, Brym, Brym, Brym, Brym, Brym, Brym, Brym, Brym, Brym^Vymb, Brym, Brym, Brym^Fynt, Brym, Brym, Btym, Btym, Brym, Cmy, Cmy, Xomy, Xomy, Xomy, Xomy, Xomy, Xomy
Wwt, Ww^Ewf, Gg^Efm, Gg, Wwt^Ewf, Wwt^Vyth, Gg^Fet, Gg^Efm, Gg, Gg, Gg, Gg, Cmy^Xo, Brym, Brym, Cmy, Cmy, Brym, Brym, Brym, Brym, Brym, Brym, Brym, Cmy, Brym, Brym, Brym, Brym, Brym, Brym, Brym, Brym, Brym, Brym, Btym, Brym, Brym, Brym, Xomy, Brym, Brym, Brym, Brym, Brym
Wwt, Wwt, Wwt, Gg^Efm, Wwt, Wwt, Wwt, Gg^Efm, Gg, Gg, Gg, Gg, Cmy, Brym, Brym, Cmy, Brym^Bryl, Brym, Brym, Btyb, Brym, Brym, Brym, Cmy, Cmy, Brym, Brym, Brym, Btyb, Brym, Brym, Brym^Lymp, Brym, Brym, Brym^Vymb, Brym, Brym, Brym, Btyb, Brym, Brym, Brym, Brym, Brym^Lymp, Brym
Wwt, Wwt, Wwt^Ewf, Wwt, Wwt, Wwt^Ewf, Gg^Efm, Wwt, Wwt, Gg, Cmy^Xo, Cmy^Xo, Brym, Brym, Brym, Brym, Brym, Brym, Brym, Btym, Brym, Brym, Brym, Brym^Bryl, Brym, Brym, Brym, Btyb, Btym, Btyb, Brym, Brym, Brym, Brym, Brym, Brym, Brym, Brym, Btym, Brym, Brym, Brym, Brym, Brym, Brym
Gg^Efm, Gg^Efm, Wwt, Wwt^Fynt, Wwt, Gg^Efm, Wwt, Wwt, Wwt, Gg, Cmy^Xo, Brym, Brym, Brym, Brym, Brym, Brym, Btyb^Bryu, Brym, Brym^Asty, Brym, Btyb^Bryu, Brym, Brym, Brym, Brym, Brym, Btym, Btym, Btym, Brym, Brym, Brym, Brym, Brym, Brym, Brym^Vymb, Brym, Btym, Brym, Brym, Brym^Vymb, Brym, Brym, Brym
Gg^Fmf, Gg, Gg^Efm, Wwt^Ewf, Wwt, Gg, Gg^Fds, Ww^Ewf, Gg, Gg, Cmy^Xo, Brym, Brym, Brym, Brym, Brym, Brym, Btym, Brym, Brym, Brym, Btym, Brym, Brym, Brym, Brym, Brym, Btym, Btym, Btym, Brym, Brym, Brym, Brym^Lymp, Brym, Brym, Brym, Brym, Brym, Brym, Brym, Brym, Brym, Brym, Brym
Gg^Fp, Gg^Fp, Gg, Btyb, Gg, Gg, Gg, Gg^Fp, Gg^Efm, Gg, Brym^Bryl, Brym, Brym, Brym, Brym, Brym, Brym^Bryl, Brym, Brym, Brym^Fynt, Brym, Brym, Brym^Bryl, Brym, Brym, Brym, Brym, Brym^Bryl, Brym, Brym^Bryl, Brym, Brym, Brym^Vymb, Brym, Brym, Brym, Btyb, Brym, Brym, Rrc^Lymp, Btyb, Btyb, Brym, Brym, Brym
Brym, Btyb, Btyb, Btym, Gg^Efm, Gg, Btyb, Gg, Btyb, Btyb, Brym, Brym, Brym, Brym, Brym, Cmy, Cmy, Brym, Brym, Brym, Brym, Brym, Cmy, Cmy, Brym, Brym, Brym, Brym, Brym^Vymb, Brym, Brym, Brym, Brym, Brym, Brym, Brym, Btym, Brym, Brym, Btym, Btym, Btym, Brym, Brym^Bryl, Brym
Brym, Btym, Btym, Btym, Btyb, Btyb, Btym, Btyb, Btym, Btym, Brym, Brym, Brym, Brym, Brym, Cmy, Brym, Brym, Brym, Brym, Brym, Brym, Brym, Cmy, Brym, Brym, Brym, Brym, Brym, Brym, Brym, Brym, Brym, Brym, Brym, Btyb, Btym, Brym, Btyb, Btym, Btym, Btym, Btym^Sy|, Btyb, Btyb
Brym, Btym, Btym, Btym, Btym, Btym, Btym, Btym, Btym, Btym, Brym, Brym^Lymp, Btyb, Brym, Brym, Brym, Brym, Btyb, Btyb, Brym, Brym, Brym, Brym, Brym, Brym, Brym, Btyb, Brym^Bryu, Brym, Btyb, Brym, Brym^Lymp, Brym, Brym, Btyb, Btym, Btym, Btyb, Btym, Btym, Btym, Btym, Btym^Sy|, Btym, Btym
Brym, Btym, Btym, Btym, Btym, Btym, Btym, Btym, Btym, Btym, Btym, Brym, Btym, Btyb, Btyb, Brym, Brym, Btym, Btym, Brym, Brym, Brym^Vymb, Brym, Brym, Brym, Brym, Btym, Brym, Brym, Btym, Brym, Brym, Btyb, Btyb, Btym, Btym, Btym, Btym, Btym, Btym, Btym, Btym, Btym^Sy|, Btym, Btym
Brym, Btym, Btym, Btym, Btym, Btym, Btym, Btym, Btym, Btym, Btym, Btym, Btym, Btym, Btym, Brym, Brym, Btym, Btym, Brym^Bryu, Brym, Brym, Brym, Brym, Brym^Vymb, Brym, Btym, Brym, Brym, Btym, Btyb, Btyb, Btym, Btym, Btym, Btym, Btym, Btym, Btym, Btym, Btym, Btym, Brym, Btym, Btym
Gg, Btym, Btym, Btym, Btym, Btym, Brym^Lymp, Btym, Brym, Brym^Lymp, Btym, Btym, Btym, Btym, Btym, Btym, Btym, Btym, Btym, Brym, Btyb, Brym, Brym, Brym, Brym, Brym, Brym^Bryu, Brym, Btyb, Btym, Btym, Btym, Btym, Btym, Btym, Btym, Btym, Btym, Brym, Brym, Brym, Brym, Brym^Vymb, Brym, Btym
Gg, Gg, Gg, Gg, Brym, Brym, Brym, Brym, Brym^Fynt, Brym, Brym, Btym, Btym, Btym, Btym, Btym, Btym, Btym, Btym, Btyb, Btyb, Btyb, Brym^Sy|, Brym, Brym, Brym, Brym, Brym, Btym, Btym, Btym, Btym, Btym, Btym, Brym, Btym, Brym, Btym, Brym, Btyb, Brym, Brym, Brym, Brym, Btym
Btym, Gg, Brym, Gg, Brym, Brym, Brym, Brym, Brym, Brym, Brym, Brym, Brym, Btym, Btym, Btym, Btym, Btym, Btym, Btym, Btym, Btym, Brym^Sy|, Btym, Btym, Btym, Btym, Btym, Btym, Btym, Btym, Btym, Btym, Btym, Brym, Brym, Brym, Brym, Brym, Btym, Brym, Brym, Brym, Brym, Btym
Btym, Brym, Btym, Brym, Btym, Brym, Btym, Btyb, Btyb, Brym, Btyb, Btyb, Brym^Sy|, Btyb, Btym, Btym, Btym, Btym, Btym, Btym, Btym, Btym, Brym^Sy|, Btym, Btym, Btym, Btym, Btym, Btym, Btym, Btym, Btym, Brym^Vymb, Btym, Btym, Btym, Btym, Btym, Btym, Btym, Btym, Btym, Btym^Sy|, Btym, Btym
Brym, Btym, Btym, Btym, Btym, Btym, Btym, Btym, Btym, Btyb, Btym, Btym, Brym^Sy|, Btym, Btym, Brym, Brym, Btym, Btym, Btym, Btym, Btym, Brym^Sy|, Btym, Btym, Btym, Btym, Btym, Btym, Btym, Btym, Brym, Brym, Brym, Btym, Btym, Btym, Btym, Btym, Btym, Btym, Btym, Btym^Sy|, Btym, Brym
Brym, Btym, Brym, Btym, Wwt^Vyth, Btym, Wwt^Vyth, Btym, Btym, Btym, Btym, Btym, Brym, Btym, Brym, Brym, Brym, Brym, Brym, Btym, Btym, Btym, Brym, Btym, Btym, Btym, Btym, Btym, Btym, Btym, Btym, Brym, Brym, Btyb, Brym, Gg, Gg^Fynt, Gg, Brym, Btym, Brym, Brym^Vymb, Brym, Brym, Brym
Brym, Brym, Brym, Brym, Wwt^Vyth, Wwt^Vyth, Wwt^Vyth, Brym, Brym, Btym, Brym, Brym, Brym, Brym, Brym, Brym, Gg, Gg, Gg, Brym, Brym^Bryl, Cmy, Cmy, Cmy, Brym^Bryl, Brym, Btym, Brym, Btym, Btyb, Brym, Brym^Vymb, Brym, Btym, Brym, Gg, Gg, Gg, Brym, Brym, Brym, Brym, Brym^Lymp, Brym^Vymb, Brym
Brym, Btyb, Brym, Brym, Brym, Wwt^Vyth, Brym, Brym, Brym, Brym, Btyb, Brym, Brym, Brym^Vymb, Brym, Btyb, Gg, Rrc^Fynt, Gg, Brym, Brym, Brym, Brym, Brym, Brym, Brym, Brym, Brym, Brym, Btym, Btym, Brym, Btyb, Btym, Btyb, Brym, Brym, Brym, Brym, Brym, Brym, Brym, Brym, Brym, Brym
Brym, Btym, Btyb, Btyb, Btyb, Brym, Btyb, Brym, Brym, Brym, Btym, Brym, Brym, Brym, Brym, Btym, Brym, Gg, Brym, Brym, Btyb, Brym, Brym, Brym, Brym, Brym^Lymp, Brym, Brym, Brym, Btym, Btym, Btym, Btym, Btym, Btym, Btym, Btym, Brym, Brym, Btyb, Brym, Brym^Vymb, Brym, Brym, Brym
Brym, Btym, Btym, Btym, Btym, Brym, Btym, Brym, Btyb, Brym, Btym, Brym, Btyb, Brym, Btyb, Btym, Brym, Brym, Brym, Brym, Btym, Brym, Btyb, Brym, Brym, Brym, Brym, Brym, Brym, Brym, Btym, Btym, Btym, Btym, Btym, Btym, Btym, Brym, Brym, Btym, Brym, Btyb, Brym, Brym, Btyb
Brym, Btym, Btym, Btym, Btym, Btym, Btym, Btym, Btym, Btym, Btym, Btym, Btym, Btym, Btym, Btym, Btym, Btyb, Brym, Btyb, Btym, Btyb, Btym, Btyb, Btym, Btym^Sy|, Btym, Btyb, Btym, Brym, Brym, Btym, Btym, Btym, Btym, Btym, Btym, Btym, Btym, Btym, Btym, Btym, Btym, Brym, Btym
Brym, Btym, Btym, Btym, Btym, Btym, Btym, Btym, Btym, Btym, Btym, Btym, Btym, Btym, Btym, Btym, Btym, Btym, Btym, Btym, Btym, Btym, Btym, Btym, Btym, Btym^Sy|, Btym, Btym, Btym, Btym, Btym, Btym, Btym, Btym, Btym, Btym, Btym, Btym, Btym, Btym, Btym, Btym, Btym, Btym, Btym
Brym, Btym, Btym, Btym, Btym, Btym, Btym, Btym, Btym, Btym, Btym, Btym, Btym, Btym, Btym, Btym, Btym, Btym, Btym, Btym, Brym, Btym, Brym, Btym, Brym, Brym, Brym, Btym, Brym, Btym, Btym, Brym, Brym, Btym, Btym, Brym, Brym, Btym, Btym, Btym, Btym, Btym, Btym, Btym, Btym
Brym, Btym, Btym, Btym, Btym, Btym, Btym, Btym, Btym, Btym, Btym, Btym, Btym, Btym, Btym, Btym, Brym, Brym, Brym, Brym, Brym, Brym^Vymb, Brym, Brym, Ww, Ww, Ww, Brym, Brym, Brym, Brym, Brym^Vymb, Brym, Brym, Brym, Brym, Brym, Btym, Btym, Btym, Btym, Btym, Btym, Btym, Btym
Brym, Btym, Btym, Btym, Btym, Btym, Btym, Btym, Btym, Btym, Btym, Btym, Btym, Btym, Btym, Btym, Brym, Brym, Brym, Brym, Brym, Brym, Brym, Brym, Ww, Ww^Fynt, Ww, Brym, Brym, Brym, Brym, Brym, Brym, Brym, Brym, Brym, Brym, Brym, Brym, Btym, Brym, Btym, Brym, Btym, Btym
