border_size=1
usage=map

Btym, Btym, Btym, Btym, Btym, Btym, Btym, Btym, Btym, Btym, Btym, Btym, Btym^Bydc, Btym, Btym, Btym, Btym, Btym, Btym, Btym, Btym, Btym, Btym, Btym, Btym
Btym, Btym, Btym, Btym, Btym, Btym, Btym, Btym, Btym, Btym, Btym, Btym, Brym, Btym, Btym, Btym, Btym, Btym, Btym, Btym, Btym, Btym, Btym, Btym, Btym
Btym, Btym, Btym, Btym, Btym, Btym, Btym, Btym, Brym, Btym, Cmy, Brym, Kmy, Brym, Cmy, Btym, Btym, Btym, Btym, Btym, Btym, Btym, Btym, Btym, Btym
Btym, Btym, Btym, Btym, Btym, Btym, Btym, Btym, Brym, Brym, Brym, Brym, Brym, Brym, Brym, Brym, Brym, Btym, Btym, Btym, Btym, Btym, Btym, Btym, Btym
Brym, Btym, Btym^Bydc, Btym, Brym, Brym^Bryl, Btym, Btym, Brym, Cmy, Brym, Brym, Brym, Brym, Brym, Cmy, Brym, Btym, Btym, Btym, Btym, Brym^Bryl, Brym, Btym, Btym^Bydc
Brym, Brym^Bryl, Brym, Brym, Brym, Brym, Brym^Bryl, Btym, Btym, Brym, Brym, Brym, Cmy, Brym, Brym, Brym, Btym, Btym, Btym, Btym, Brym, Brym, Btyb, Brym^Bryl, Brym
Brym, Brym, Brym, Brym, Brym^Lymp, Brym, Brym, Btym, Btym, Btym, Btym, Brym, Brym, Brym, Btym, Btym, Btym, Btym, Btym^Bydc, Brym, Brym, Brym, Btym, Brym, Brym
Brym, Brym, Btyb, Brym, Brym, Brym, Brym, Brym, Brym, Btym, Btym, Btym, Btym^Sy|, Btym, Btym, Btym, Brym, Brym^Bryl, Brym, Brym, Brym^Lyml, Brym, Brym, Brym, Brym
Brym, Brym, Btym, Brym, Btyb, Brym, Brym, Brym, Brym, Brym, Brym, Btym, Btym^Sy|, Btym, Brym, Brym, Brym, Brym, Brym, Brym^Lymp, Brym^Lyml, Btyb, Brym, Brym, Brym
Brym, Brym, Brym, Brym, Btym, Brym, Brym, Cmy, Cmy, Brym, Brym, Cmy, Cmy, Cmy, Brym, Brym, Cmy, Cmy, Brym, Brym, Brym, Btym, Brym, Brym, Brym
Brym, Btyb, Brym, Brym, Btym, Brym, Brym, Cmy, Brym, Brym, Brym, Brym, Brym, Brym, Brym, Brym, Brym, Cmy, Brym, Brym, Brym, Btym, Brym, Brym, Brym
Brym, Btym, Brym, Brym, Brym, Brym, Brym, Brym, Brym, Brym, Brym, Brym, Brym, Brym, Brym, Brym, Brym, Brym, Brym, Brym, Brym, Brym, Brym, Btyb, Brym
Brym, Btym, Brym, Brym^Lymp, Brym, Brym, Brym, Brym^Fynt, Brym, Brym, Brym, Brym, Brym^Asty, Brym, Brym, Brym, Brym, Brym^Fynt, Brym, Brym, Brym^Lymp, Brym, Brym, Btym, Brym
Brym, Brym, Brym, Brym, Brym, Brym, Brym, Brym, Brym, Brym, Brym, Brym, Brym, Brym, Brym, Brym, Brym, Brym, Brym, Brym, Brym, Brym, Brym, Brym, Brym
Brym, Btyb, Btyb, Btyb, Btyb, Brym, Brym, Brym, Cmy, Brym, Brym, Brym, Brym, Brym, Brym, Brym, Cmy, Brym, Brym, Brym, Btyb, Btyb, Btyb, Btyb, Btyb
Brym, Btym, Btym, Btym, Btym, Brym, Brym, Cmy, Cmy, Brym, Brym, Brym, Brym, Brym, Brym, Brym, Cmy, Cmy, Brym, Brym, Btym, Btym, Btym, Btym, Btym
Btym, Btym, Btym, Btym, Btym, Brym, Brym, Brym, Brym, Brym, Brym, Brym, Brym, Brym, Brym, Brym, Brym, Brym, Brym, Brym, Btym, Btym, Btym, Btym, Btym
Brym, Btym, Btym, Btym, Btym, Btym, Btym, Brym, Brym, Brym, Brym, Cmy, Cmy, Cmy, Brym, Brym, Brym, Brym, Btym, Btym, Btym, Btym, Btym, Btym, Btym
Brym, Brym, Brym, Brym^Bryl, Brym, Btym, Btym, Btym^Sy|, Btym, Brym, Brym, Brym, Brym, Brym, Brym, Brym, Btym, Btym^Sy|, Btym, Btym, Brym, Brym^Bryl, Brym, Brym, Brym
Brym, Brym, Btyb, Brym, Brym, Brym, Cmy, Btym^Sy|, Btym, Btym, Btym, Brym, Brym, Brym, Btym, Btym, Btym, Btym^Sy|, Cmy, Brym, Brym, Brym, Brym, Brym^Lymp, Brym
Brym, Brym, Btym, Brym, Brym, Brym, Brym, Cmy, Cmy, Btym, Btym, Btym, Btym^Sy|, Btym, Btym, Btym, Cmy, Cmy, Brym, Brym, Brym, Brym^Vymb, Brym, Brym, Brym
Brym, Brym, Brym^Vymb, Brym, Brym, Brym, Brym, Brym, Brym, Cmy, Cmy, Btym, Btym^Sy|, Btym, Cmy, Cmy, Brym, Brym, Brym, Brym, Brym, Brym, Brym, Brym, Brym
Brym, Brym, Brym, Brym, Btyb, Brym, Brym, Brym, Btyb, Brym, Brym, Cmy, Cmy, Cmy, Brym, Brym, Brym, Btyb, Brym, Brym, Btyb, Brym, Brym^Vymb, Brym, Brym
Brym, Brym, Brym, Brym, Btym, Brym, Brym, Brym, Btym, Brym, Brym, Brym, Brym, Brym, Brym, Brym, Brym, Btym, Brym^Vymb, Brym, Btym, Brym, Brym, Brym, Brym
Brym, Brym, Brym, Brym, Btym, Brym, Brym^Vymb, Brym, Brym, Brym, Brym, Brym, Brym, Brym, Brym, Brym, Brym, Brym, Brym, Brym, Btym, Brym, Brym, Brym, Brym
Brym, Brym^Lymp, Brym, Brym, Brym, Brym, Brym, Brym, Brym, Brym, Brym, Brym, Brym, Brym, Brym, 1 Brym, Brym, Brym, Brym, Brym, Brym, Brym, Brym, Brym^Lymp, Brym
Brym, Brym, Brym, Brym, Brym, Brym, Brym, Brym, Brym, Brym, Brym, Brym, Brym, Brym, Brym, Brym, Brym, Brym, Brym, Brym, Brym, Brym, Brym, Brym, Brym
