border_size=1
usage=map

Xomy, Xomy, Xomy, Brym, Brym, Brym, Brym, Brym, Brym, Xomy, Xomy, Xomy, Xomy, Xomy, Xomy, Xomy, Xomy, Xomy, Xomy, Xomy, Xomy, Xomy, Xomy, Xomy, Xomy, Xomy, Xomy, Xomy, Xomy, Xomy, Woby^Xo, Woby^Xo, Woby, Woby, Woby, Woby, Woby, Woby, Woby, Woby, Woby, Woby, Woby, Woby, Woby, Woby, Woby, Woby, Woby
Xomy, Xomy, Xomy, Xomy, Xomy, Brym, Brym, Brym, Brym, Brym, Brym, Xomy, Xomy, Xomy, Brym^Bryl, Xomy, Xomy, Xomy, Xomy, Xomy, Xomy, Xomy, Xomy, Xomy, Xomy, Xomy, Xomy, Xomy, Xomy, Xomy, Woby^Xo, Woby^Xo, Woby, Woby, Woby, Woby, Woby, Woby, Woby, Woby, Woby, Woby, Woby, Woby, Woby, Woby, Woby, Woby, Woby
Xomy, Xomy, Xomy, Xomy, Xomy, Xomy, Xomy, Brym, Brym, Brym, Brym, Brym, Brym, Brym, Brym, Brym, Brym, Xomy, Xomy, Xomy, Xomy, Xomy, Xomy, Xomy, Xomy, Xomy, Xomy, Xomy, Xomy, Xomy, Woby^Xo, Woby^Xo, Woby, Woby, Woby, Woby, Woby, Woby, Woby, Woby, Woby, Woby, Woby, Woby, Woby, Woby, Woby, Woby, Woby
Xomy, Xomy, Xomy, Xomy, Xomy, Xomy, Xomy, Xomy, Xomy, Brym, Brym, Brym, Brym, Brym, Btyb, Brym, Brym, Brym, Brym, Xomy, Xomy, Xomy, Xomy, Xomy, Xomy, Xomy, Xomy, Xomy, Xomy, Xomy, Woby^Xo, Woby^Xo, Woby, Woby, Woby, Woby, Woby, Woby, Woby, Woby, Woby, Woby, Woby, Woby, Woby, Woby, Woby, Woby, Woby
Xomy, Xomy, Xomy, Xomy, Xomy, Xomy, Xomy, Xomy, Brym, Brym, Brym^Vymb, Brym, Brym, Brym, Btym, Btyb, Brym, Brym, Brym, Brym, Brym, Xomy, Xomy, Xomy, Xomy, Xomy, Xomy, Xomy, Xomy, Xomy, Woby^Xo, Woby^Xo, Woby, Woby, Woby, Woby, Woby, Woby, Woby, Woby, Woby, Woby, Woby, Gll^Fet, Woby, Woby, Woby, Woby, Woby
Xomy, Xomy, Xomy, Xomy, Xomy, Xomy, Xomy, Brym^Bryl, Brym, Brym, Brym, Brym, Brym, Brym, Btym, Btym, Brym, Brym, Brym, Brym, Brym, Brym, Brym^Bryl, Xomy, Xomy, Xomy, Xomy, Xomy, Xomy, Xomy, Woby^Xo, Woby^Xo, Woby, Woby, Woby, Woby, Woby, Woby, Woby, Woby, Woby, Woby, Woby, Woby, Woby, Woby, Woby, Woby, Woby
Xomy, Xomy, Xomy, Xomy, Xomy, Xomy, Xomy, Xomy, Xomy, Brym, Brym, Brym, Brym, Brym, Brym, Btym, Brym, Brym, Brym, Brym^Vymb, Brym, Brym, Xomy, Xomy, Xomy, Xomy, Xomy, Xomy, Xomy, Xomy, Woby^Xo, Woby^Xo, Woby, Woby, Woby, Woby, Woby, Woby, Woby, Woby, Woby, Woby, Woby, Woby, Woby, Woby, Woby, Woby, Woby
Xomy, Xomy, Xomy, Xomy, Xomy, Xomy, Xomy, Xomy, Xomy, Xomy, Brym, Brym, Brym, Brym, Brym^Vymb, Brym, Brym, Brym, Brym, Brym, Xomy, Xomy, Xomy, Xomy, Xomy, Xomy, Xomy, Xomy, Xomy, Xomy, Woby^Xo, Woby^Xo, Woby, Woby, Woby, Woby, Woby, Woby, Woby, Woby, Woby, Woby, Woby, Woby, Woby, Woby, Woby, Woby, Woby
Xomy, Xomy, Xomy, Xomy, Xomy, Xomy, Xomy, Xomy, Brym, Brym, Xomy, Xomy, Xomy, Brym, Brym, Brym, Brym, Brym, Xomy, Brym^Gye, Brym, Xomy, Xomy, Xomy, Xomy, Xomy, Xomy, Xomy, Xomy, Xomy, Woby^Xo, Woby^Xo, Woby, Woby, Woby, Woby, Woby, Woby, Woby, Woby, Woby, Woby, Woby, Woby, Woby, Woby, Woby, Woby, Woby
Xomy, Xomy, Xomy, Xomy, Xomy, Xomy, Xomy, Brym, Xomy, Xomy, Xomy, Xomy, Xomy, Xomy, Xomy, Brym^Bryl, Xomy, Xomy, Xomy, Xomy, Xomy, Xomy, Xomy, Xomy, Xomy, Xomy, Xomy, Xomy, Xomy, Xomy, Woby^Xo, Woby^Xo, Woby, Woby, Woby, Woby, Woby, Woby, Woby, Woby, Woby, Woby, Woby, Woby, Woby, Woby, Woby, Woby, Woby
Xomy, Xomy, Xomy, Xomy, Xomy, Xomy, Xomy, Brym, Xomy, Xomy, Xomy, Xomy, Xomy, Xomy, Xomy, Xomy, Xomy, Xomy, Xomy, Xomy, Xomy, Xomy, Xomy, Xomy, Xomy, Xomy, Xomy, Xomy, Xomy, Xomy, Woby^Xo, Woby^Xo, Woby^Xo, Woby, Woby, Woby, Woby, Woby, Woby, Woby, Woby, Woby, Woby, Woby, Woby, Woby, Woby, Woby, Woby
Xomy, Xomy, Xomy, Xomy, Xomy, Xomy, Brym, Brym, Xomy, Xomy, Xomy, Xomy, Xomy, Xomy, Xomy, Xomy, Xomy, Xomy, Xomy, Xomy, Xomy, Xomy, Xomy, Xomy, Xomy, Xomy, Xomy, Xomy, Xomy, Xomy, Xomy, Woby^Xo, Woby^Xo, Woby^Xo, Woby^Xo, Woby, Woby, Woby, Woby, Woby, Woby, Woby, Woby, Woby, Woby, Woby, Woby, Woby, Woby
Xomy, Xomy, Xomy, Xomy, Brym^Gyw, Brym, Brym, Xomy, Xomy, Xomy, Xomy, Xomy, Xomy, Xomy, Xomy, Xomy, Xomy, Xomy, Xomy, Xomy, Xomy, Xomy, Xomy, Xomy, Xomy, Xomy, Xomy, Xomy, Xomy, Xomy, Xomy, Xomy, Xomy, Woby^Xo, Woby^Xo, Woby^Xo, Woby^Xo, Woby, Woby, Woby, Woby^Xo, Woby, Woby, Woby, Woby^Xo, Woby, Woby^Xo, Woby, Woby^Xo
Xomy, Xomy, Xomy, Brym, Brym, Xomy, Xomy, Brym, Brym, Xomy, Xomy, Xomy, Xomy, Xomy, Xomy, Xomy, Xomy, Xomy, Xomy, Xomy, Xomy, Xomy, Xomy, Xomy, Xomy, Xomy, Xomy, Xomy, Xomy, Xomy, Xomy, Xomy, Xomy, Xomy, Xomy, Woby^Xo, Woby^Xo, Woby^Xo, Woby^Xo, Woby^Xo, Woby^Xo, Woby^Xo, Woby^Xo, Woby^Xo, Woby^Xo, Woby^Xo, Woby^Xo, Woby^Xo, Woby^Xo
Xomy, Xomy, Xomy, Xomy, Xomy, Xomy, Xomy, Xomy, Xomy, Brym, Xomy, Xomy, Xomy, Xomy, Xomy, Xomy, Xomy, Xomy, Xomy, Xomy, Xomy, Xomy, Xomy, Xomy, Xomy, Xomy, Xomy, Xomy, Xomy, Xomy, Xomy, Xomy, Xomy, Xomy, Xomy, Xomy, Xomy, Woby^Xo, Woby^Xo, Woby^Xo, Xomy, Woby^Xo, Woby^Xo, Woby^Xo, Xomy, Woby^Xo, Xomy, Woby^Xo, Xomy
Xomy, Xomy, Xomy, Xomy, Xomy, Xomy, Xomy, Xomy, Xomy, Brym, Xomy, Xomy, Brym, Brym, Brym, Xomy, Xomy, Xomy, Xomy, Xomy, Xomy, Xomy, Xomy, Xomy, Xomy, Xomy, Xomy, Xomy, Xomy, Xomy, Xomy, Xomy, Xomy, Xomy, Xomy, Xomy, Xomy, Xomy, Xomy, Xomy, Xomy, Xomy, Xomy, Xomy, Xomy, Xomy, Xomy, Xomy, Xomy
Xomy, Xomy, Xomy, Xomy, Brym, Xomy, Xomy, Xomy, Xomy, Brym, Brym, Brym, Xomy, Xomy, Brym, Brym, Brym, Xomy, Xomy, Xomy, Xomy, Xomy, Xomy, Xomy, Xomy, Xomy, Xomy, Xomy, Xomy, Xomy, Xomy, Xomy, Xomy, Xomy, Xomy, Xomy, Xomy, Xomy, Xomy, Xomy, Xomy, Xomy, Xomy, Xomy, Xomy, Xomy, Xomy, Xomy, Xomy
Xomy, Xomy, Xomy, Xomy, Xomy, Brym^Gye, Brym, Xomy, Xomy, Xomy, Xomy, Xomy, Xomy, Brym, Brym, Brym, Brym^Bryu, Xomy, Xomy, Xomy, Xomy, Xomy, Xomy, Xomy, Xomy, Xomy, Xomy, Xomy, Xomy, Xomy, Xomy, Xomy, Xomy, Xomy, Xomy, Xomy, Xomy, Xomy, Xomy, Xomy, Xomy, Xomy, Xomy, Xomy, Xomy, Xomy, Xomy, Xomy, Xomy
Xomy, Xomy, Xomy, Xomy, Xomy, Xomy, Brym, Brym, Brym, Xomy, Xomy, Xomy, Xomy, Brym^Bryu, Brym, Brym, Xomy, Xomy, Xomy, Xomy, Xomy, Xomy, Xomy, Xomy, Xomy, Xomy, Xomy, Xomy, Xomy, Xomy, Xomy, Xomy, Xomy, Xomy, Xomy, Xomy, Wuyb, Xomy, Wuyb, Xomy, Wuyb, Xomy, Wuyb, Xomy, Xomy, Xomy, Xomy, Xomy, Xomy
Xomy, Xomy, Xomy, Xomy, Xomy, Brym^Bryl, Brym, Brym, Brym, Brym^Bryl, Xomy, Xomy, Xomy, Xomy, Xomy, Xomy, Xomy, Xomy, Xomy, Xomy, Xomy, Xomy, Xomy, Xomy, Xomy, Xomy, Xomy, Xomy, Xomy, Xomy, Xomy, Xomy, Xomy, Xomy, Wuyb, Wuyb, Wuyb, Wuyb, Wuyb, Wuyb, Wuyb, Wuyb, Wuyb, Xomy, Xomy, Xomy, Xomy, Xomy, Xomy
Xomy, Xomy, Xomy, Xomy, Xomy, Btym, Btym, Brym, Btym, Btym, Xomy, Xomy, Xomy, Xomy, Xomy, Xomy, Xomy, Xomy, Xomy, Xomy, Xomy, Xomy, Wuyb, Xomy, Wuyb, Xomy, Wuyb, Xomy, Wuyb, Xomy, Xomy, Xomy, Wuyb, Wuyb, Wuyb, Wuyb, Wuyb, Wuyb, Qxu, Wuyb, Wuyb, Wuyb, Wuyb, Wuyb, Wuyb, Xomy, Wuyb, Xomy, Wuyb
Wuyb, Xomy, Wuyb, Wuyb, Wuyb, Wuyb, Btym, Btym^Sy|, Btym, Wuyb, Xomy, Xomy, Xomy, Xomy, Wuyb, Xomy, Wuyb, Xomy, Wuyb, Wuyb, Wuyb, Wuyb, Wuyb, Wuyb, Wuyb, Wuyb, Wuyb, Wuyb, Wuyb, Wuyb, Wuyb, Wuyb, Wuyb, Wuyb, Wuyb, Wuyb, Wuyb, Qxu, Wuyb, Qxu, Wuyb, Wuyb, Wuyb, Wuyb, Wuyb, Wuyb, Wuyb, Wuyb, Wuyb
Wuyb, Wuyb, Wuyb, Wuyb, Wuyb, Wuyb, Mybd, Btym^Sy|, Mybd, Wuyb, Wuyb, Wuyb, Wuyb, Wuyb, Wuyb, Wuyb, Wuyb, Wuyb, Wuyb, Wuyb, Wuyb, Wuyb, Wuyb, Wuyb, Wuyb, Wuyb, Wuyb, Wuyb, Wuyb, Wuyb, Wuyb, Wuyb, Wuyb, Wuyb, Wuyb, Wuyb, Qxu, Qxu, Wuyb, Wuyb, Wuyb, Wuyb, Wuyb, Wuyb, Wuyb, Wuyb, Wuyb, Wuyb, Wuyb
Wuyb, Wuyb, Wuyb, Wuyb, Urfz, Mybd, Mybd, Mybd, Urfz, Wuyb, Wuyb, Wuyb, Wuyb, Wuyb, Wuyb, Wuyb, Wuyb, Wuyb, Wuyb, Wuyb, Wuyb, Wuyb, Wuyb, Wuyb, Wuyb, Wuyb, Wuyb, Wuyb, Wuyb, Wuyb, Qxu, Wuyb, Wuyb, Wuyb, Woby, Woby, Woby, Wuyb, Qxu, Wuyb, Wuyb, Wuyb, Wuyb, Wuyb, Wuyb, Wuyb, Wuyb, Wuyb, Wuyb
Wuyb, Wuyb, Wuyb, Wuyb, Mybd, Mybd, Urfz, Urfz, Wuyb, Wuyb, Wuyb, Wuyb, Wuyb, Wuyb, Wuyb, Wuyb, Wuyb, Wuyb, Wuyb, Wuyb, Woby, Wuyb, Wuyb, Wuyb, Wuyb, Wuyb, Wuyb, Wuyb, Wuyb, Wuyb, Wuyb, Qxu, Qxu, Wuyb, Woby, Woby, Gll^Fet, Woby, Woby, Qxu, Qxu, Qxu, Qxu, Wuyb, Wuyb, Wuyb, Wuyb, Wuyb, Wuyb
Wuyb, Wuyb, Wuyb, Wuyb, Mybd, Wuyb, Wuyb, Wuyb, Wuyb, Wuyb, Wuyb, Wuyb, Wuyb, Wuyb, Wuyb, Wuyb, Wuyb, Wuyb, Wuyb, Woby, Mybd, Woby, Urfz, Mybd, Mybd, Woby, Woby, Wuyb, Wuyb, Wuyb, Wuyb, Wuyb, Qxu, Qxu, Woby, Woby, Woby, Woby, Woby, Wuyb, Wuyb, Wuyb, Wuyb, Wuyb, Wuyb, Wuyb, Wuyb, Wuyb, Wuyb
Wuyb, Wuyb, Wuyb, Wuyb, Mybd, Wuyb, Wuyb, Wuyb, Wuyb, Wuyb, Wuyb, Wuyb, Wuyb, Wuyb, Wuyb, Wuyb, Wuyb, Wuyb, Wuyb, Woby, Mybd, Mybd, Wuyb, Urfz, Wuyb, Mybd, Woby, Woby, Wuyb, Wuyb, Wuyb, Qxu, Wuyb, Woby, Woby, Woby, Woby, Woby, Woby, Wuyb, Wuyb, Wuyb, Wuyb, Wuyb, Wuyb, Wuyb, Wuyb, Wuyb, Wuyb
Wuyb, Wuyb, Wuyb, Wuyb, Wuyb, Urfz, Urfz, Wuyb, Wuyb, Wuyb, Wuyb, Wuyb, Wuyb, Wuyb, Wuyb, Wuyb, Wuyb, Wuyb, Wuyb, Mybd, Urfz, Wuyb, Wuyb, Wuyb, Wuyb, Wuyb, Wuyb, Wuyb, Wuyb, Wuyb, Wuyb, Wuyb, Wuyb, Wuyb, Woby, Woby, Wuyb, Woby, Woby, Woby, Woby, Wuyb, Wuyb, Wuyb, Wuyb, Wuyb, Wuyb, Wuyb, Wuyb
Wuyb, Wuyb, Wuyb, Wuyb, Wuyb, Wuyb, Wuyb, Mybd, Mybd, Wuyb, Mybd, Wuyb, Urfz, Wuyb, Urfz, Wuyb, Wuyb, Wuyb, Mybd, Urfz, Wuyb, Wuyb, Wuyb, Wuyb, Wuyb, Wuyb, Wuyb, Wuyb, Wuyb, Wuyb, Qxu, Wuyb, Qxu, Qxu, Woby, Wuyb, Wuyb, Wuyb, Woby, Woby, Woby, Woby, Woby, Wuyb, Wuyb, Wuyb, Wuyb, Wuyb, Wuyb
Wuyb, Wuyb, Wuyb, Wuyb, Wuyb, Wuyb, Wuyb, Wuyb, Wuyb, Mybd, Mybd, Urfz, Mybd, Mybd, Mybd, Mybd, Mybd, Mybd, Wuy, Fypd, Fypd, Fypd^Cov, Fypd^Kov, Wuyb, Wuyb, Wuyb, Wuyb, Wuyb, Wuyb, Wuyb, Wuyb, Qxu, Wuyb, Wuyb, Woby, Woby, Woby, Woby, Wuy, Wuy, Woby, Wuy, Woby, Woby, Qxu, Qxu, Qxu, Qxu, Wuyb
Wuyb, Wuyb, Wuyb, Wuyb, Fypd, Fypd, Fypd, Wuyb, Fypd, Fypd, Wuy, Mybd, Mybd, Mybd, Cay, Mybd, Wuy, Mybd, Fypd, Wuy, Fypd, Fypd^Cov, Fypd^Fyod, Fypd^Fyod, Wuyb, Wuyb, Wuyb, Wuyb, Wuyb, Wuyb, Wuyb, Wuyb, Wuyb, Wuy, Wuy, Wuy, Wuy, Wuy, Wuy, Wuy, Woby, Woby, Wuyb, Wuyb, Wuyb, Wuyb, Wuyb, Wuyb, Wuyb
Wuyb, Wuyb, Wuyb, Fypd, Fypd^Cov, Fypd, Fypd, Fypd, Wuy, Fypd, Wuy, Mybd, Mybd, Kay, Cay, Mybd, Mybd, Mybd, Wuy, Fypd, Wuy, Fypd, Fypd, Wuyb, Woby, Wuyb, Wuyb, Wuyb, Wuyb, Wuyb, Wuyb, Wuyb, Wuy, Wuy, Wuy, Wuy, Wuy, Wuy, Woby, Woby, Wuyb, Wuyb, Wuyb, Wuyb, Wuyb, Wuyb, Wuyb, Wuyb, Wuyb
Wuyb, Wuyb, Wuyb, Fypd, Fypd^Kov, Fypd^Cov, Fypd, Wuy, Fypd, Fypd, Mybd, Mybd, Mybd, Cay, Mybd, Mybd, Mybd, Mybd, Mybd, Mybd, Urfz, Wuy, Mybd, Woby, Wuyb, Woby, Woby, Wuyb, Wuyb, Wuy, Wuy, Wuy, Woby, Woby, Woby, Woby, Woby, Woby, Woby, Wuyb, Wuyb, Wuyb, Wuyb, Qxu, Wuyb, Wuyb, Wuyb, Wuyb, Wuyb
Wuyb, Wuyb, Wuyb, Fypd, Fypd, Fypd^Cov, Wuy, Fypd^Fyod, Fypd^Fyod, Mybd, Mybd, Mybd, Mybd, Mybd, Wuyb, Mybd, Wuyb, Mybd, Mybd, Mybd, Wuyb, Urfz, Urfz, Mybd, Wuyb, Wuyb, Woby, Wuyb, Wuyb, Wuyb, Wuy, Woby, Woby, Woby, Woby, Woby, Woby, Woby, Wuyb, Wuyb, Wuyb, Wuyb, Woby, Woby, Wuyb, Wuyb, Wuyb, Wuyb, Wuyb
Wuyb, Wuyb, Wuyb, Fypd, Fypd, Fypd, Fypd, Wuy, Fypd, Mybd, Urfz, Wuyb, Wuyb, Wuyb, Wuyb, Wuyb, Wuyb, Wuyb, Mybd, Urfz, Wuyb, Wuyb, Wuyb, Wuyb, Wuyb, Wuyb, Wuyb, Wuyb, Wuyb, Wuyb, Wuyb, Wuy, Woby, Woby, Wuyb, Wuyb, Woby, Wuyb, Woby, Wuyb, Woby, Wuyb, Woby, Wuyb, Wuyb, Wuyb, Wuyb, Wuyb, Wuyb
Wuyb, Wuyb, Wuyb, Wuyb, Wuyb, Wuyb, Wuyb, Fypd, Wuyb, Wuyb, Urfz, Wuyb, Wuyb, Wuyb, Wuyb, Wuyb, Wuyb, Urfz, Wuyb, Urfz, Woby, Woby, Woby, Wuyb, Wuy, Wuy, Wuy, Wuy, Wuy, Wuyb, Wuy, Wuy, Woby, Woby, Wuyb, Wuyb, Wuyb, Woby, Wuyb, Woby, Woby, Woby, Wuyb, Wuyb, Wuyb, Wuyb, Wuyb, Wuyb, Wuyb
Wuyb, Wuyb, Wuyb, Wuyb, Wuyb, Wuyb, Wuyb, Wuyb, Wuyb, Urfz, Wuyb, Wuyb, Wuyb, Wuyb, Wuyb, Wuyb, Urfz, Urfz, Wuyb, Wuyb, Wuyb, Wuyb, Wuyb, Wuyb, Wuyb, Wuy, Wuy, Qxu, Qxu, Wuy, Woby, Woby, Woby, Wuyb, Wuyb, Woby, Woby, Wuyb, Woby, Woby, Woby, Woby, Wuyb, Wuyb, Wuyb, Wuyb, Wuyb, Wuyb, Wuyb
Wuyb, Wuyb, Wuyb, Wuyb, Wuyb, Wuyb, Wuyb, Wuyb, Mybd, Urfz, Mybd, Wuyb, Wuyb, Wuyb, Wuyb, Wuyb, Urfz, Wuyb, Mybd, Wuyb, Wuyb, Wuyb, Wuyb, Wuyb, Wuyb, Wuyb, Wuyb, Wuy, Wuy, Qxu, Woby, Wuyb, Woby, Wuyb, Wuyb, Wuyb, Woby, Woby, Wuy, Wuy, Wuy, Woby, Wuyb, Wuyb, Wuyb, Wuyb, Wuyb, Wuyb, Wuyb
Wuyb, Wuyb, Wuyb, Wuyb, Wuyb, Wuyb, Wuyb, Wuyb, Wuyb, Mybd, Mybd, Tyb, Tyb, Wuyb, Mybd, Mybd, Mybd, Mybd, Mybd, Woby, Woby, Wuyb, Wuyb, Wuyb, Wuyb, Wuyb, Wuyb, Wuyb, Wuyb, Woby, Wuyb, Woby, Woby, Woby, Woby, Woby, Wuy, Woby, Wuy, Wuy, Wuy, Woby, Woby, Wuyb, Wuyb, Wuyb, Wuyb, Wuyb, Wuyb
Wuyb, Wuyb, Wuyb, Wuyb, Wuyb, Wuyb, Wuyb, Wuyb, Urfz, Mybd, Tyb, Tyb, Mybd, Mybd, Urfz, Mybd, Wuyb, Mybd, Mybd, Wuyb, Wuyb, Wuyb, Wuyb, Wuyb, Wuyb, Wuyb, Wuyb, Wuyb, Wuyb, Wuyb, Wuyb, Wuyb, Wuyb, Woby, Woby, Wuy, Wuy, Woby, Wuy, Wuy, Wuy, Woby, Woby, Woby, Wuyb, Wuyb, Wuyb, Wuyb, Wuyb
Wuyb, Wuyb, Wuyb, Wuyb, Wuyb, Wuyb, Mybd, Urfz, Mybd, Mybd, Wuy, Tyb, Wuyb, Urfz, Wuyb, Wuyb, Wuyb, Wuyb, Mybd, Wuyb, Wuyb, Wuyb, Wuyb, Wuyb, Wuyb, Wuyb, Wuyb, Wuyb, Wuyb, Wuyb, Wuyb, Wuyb, Wuyb, Woby, Wuyb, Woby, Woby, Woby, Woby, Woby, Woby, Woby, Woby, Woby, Wuyb, Wuyb, Wuyb, Wuyb, Wuyb
Wuyb, Wuyb, Wuyb, Wuyb, Wuyb, Mybd, Mybd, Wuy, Fypd^Fyod, Fypd, Fypd, Fypd, Fypd^Cov, Wuyb, Wuyb, Wuyb, Wuyb, Wuyb, Wuyb, Urfz, Urfz, Urfz, Woby, Wuyb, Woby, Woby, Wuyb, Wuyb, Wuyb, Wuyb, Wuyb, Wuyb, Wuyb, Wuyb, Wuyb, Wuyb, Wuyb, Wuyb, Wuyb, Woby, Woby, Woby, Wuyb, Woby, Woby, Qxu, Wuyb, Wuyb, Wuyb
Wuyb, Wuyb, Wuyb, Wuyb, Wuyb, Wuyb, Urfz, Mybd, Mybd, Wuy, Fypd, Fypd^Cov, Fypd^Kov, Wuyb, Wuyb, Wuyb, Wuyb, Wuyb, Wuyb, Wuyb, Wuyb, Wuyb, Wuyb, Woby, Woby, Wuyb, Wuyb, Wuyb, Wuyb, Wuyb, Woby, Wuyb, Wuyb, Wuyb, Wuyb, Wuyb, Wuyb, Wuyb, Wuyb, Wuyb, Woby, Wuyb, Wuyb, Wuyb, Wuyb, Woby, Wuyb, Wuyb, Wuyb
Wuyb, Wuyb, Wuyb, Wuyb, Wuyb, Wuyb, Wuyb, Mybd, Urfz, Mybd, Mybd, Wuyb, Wuyb, Wuyb, Mybd, Mybd, Mybd, Mybd, Mybd, Wuyb, Wuyb, Wuyb, Wuyb, Wuyb, Wuyb, Wuyb, Wuyb, Wuyb, Wuyb, Qxu, Wuyb, Woby, Woby, Wuyb, Wuyb, Wuyb, Wuyb, Wuyb, Woby, Woby, Woby, Wuyb, Wuyb, Wuyb, Wuyb, Wuyb, Wuyb, Wuyb, Wuyb
Wuyb, Wuyb, Wuyb, Wuyb, Wuyb, Wuyb, Wuyb, Wuyb, Wuyb, Urfz, Mybd, Mybd, Mybd, Wuyb, Mybd, Mybd, Fypd, Fypd, Fypd, Mybd, Mybd, Wuyb, Wuyb, Wuyb, Wuyb, Wuyb, Wuyb, Wuyb, Wuyb, Wuyb, Wuyb, Wuyb, Wuyb, Woby, Woby, Woby, Woby, Woby, Wuyb, Wuyb, Wuyb, Wuyb, Wuyb, Wuyb, Wuyb, Wuyb, Wuyb, Wuyb, Wuyb
Wuyb, Wuyb, Wuyb, Wuyb, Wuyb, Wuyb, Wuyb, Wuyb, Wuyb, Wuyb, Wuyb, Mybd, Mybd, Mybd, Fypd, Fypd, Ctym, Ctym, Ctym, Fypd^Fyod, Fypd, Mybd, Wuyb, Wuyb, Wuyb, Wuyb, Wuyb, Wuyb, Wuyb, Wuyb, Wuyb, Wuyb, Wuyb, Woby, Woby, Woby, Wuyb, Wuyb, Wuyb, Wuyb, Wuyb, Wuyb, Wuyb, Wuyb, Wuyb, Wuyb, Wuyb, Wuyb, Wuyb
Wuyb, Wuyb, Wuyb, Wuyb, Wuyb, Wuyb, Wuyb, Wuyb, Wuyb, Wuyb, Wuyb, Mybd, Mybd, Mybd, Fypd, Fypd, Ctym, Ktym, Ctym, Fypd, Fypd, Mybd, Mybd, Wuyb, Wuyb, Wuyb, Wuyb, Wuyb, Woby, Wuyb, Wuyb, Wuyb, Wuyb, Woby, Woby, Woby, Woby, Wuyb, Wuyb, Wuyb, Wuyb, Wuyb, Wuyb, Wuyb, Wuyb, Wuyb, Wuyb, Wuyb, Wuyb
Wuyb, Wuyb, Wuyb, Wuyb, Wuyb, Wuyb, Woby, Wuyb, Woby, Wuyb, Urfz, Wuyb, Mybd, Mybd, Fypd^Fyod, Fypd, Fypd, Ctym, Fypd, Fypd, Mybd, Mybd, Mybd, Wuyb, Wuyb, Wuyb, Woby, Woby, Woby, Wuyb, Wuyb, Wuyb, Wuyb, Wuyb, Wuyb, Woby, Woby, Wuyb, Wuyb, Wuyb, Wuyb, Wuyb, Wuyb, Wuyb, Wuyb, Wuyb, Wuyb, Wuyb, Wuyb
Wuyb, Wuyb, Wuyb, Wuyb, Wuyb, Wuyb, Woby, Woby, Wuyb, Mybd, Wuyb, Urfz, Mybd, Fypd, Fypd, Fypd, Fypd, Fypd, Mybd, Fypd^Fyod, Mybd, Wuyb, Urfz, Wuyb, Wuyb, Wuyb, Woby, Wuyb, Woby, Wuyb, Wuyb, Wuyb, Wuyb, Wuyb, Wuyb, Woby, Woby, Woby, Woby, Wuyb, Wuyb, Wuyb, Woby, Wuyb, Wuyb, Wuyb, Wuyb, Wuyb, Wuyb
Wuyb, Wuyb, Wuyb, Wuyb, Wuyb, Wuyb, Wuyb, Wuyb, Wuyb, Wuyb, Wuyb, Wuyb, Wuyb, Fypd, Fypd^Fyod, Fypd, Mybd, Fypd, Mybd, Mybd, Wuyb, Wuyb, Wuyb, Urfz, Urfz, Mybd, Mybd, Wuyb, Woby, Wuyb, Wuyb, Wuyb, Wuyb, Wuyb, Wuyb, Wuyb, Wuyb, Woby, Woby, Wuyb, Woby, Woby, Wuyb, Wuyb, Wuyb, Wuyb, Wuyb, Wuyb, Wuyb
Wuyb, Wuyb, Wuyb, Wuyb, Wuyb, Wuyb, Wuyb, Wuyb, Wuyb, Wuyb, Wuyb, Wuyb, Mybd, Fypd^Gyw, Wuyb, Wuyb, Wuyb, Wuyb, Wuyb, Wuyb, Wuyb, Wuyb, Wuyb, Wuyb, Wuyb, Wuyb, Wuyb, Woby, Woby, Wuyb, Wuyb, Wuyb, Wuyb, Wuyb, Wuyb, Wuyb, Wuyb, Wuyb, Woby, Woby, Wuyb, Wuyb, Wuyb, Wuyb, Wuyb, Wuyb, Wuyb, Wuyb, Wuyb
Wuyb, Wuyb, Wuyb, Wuyb, Wuyb, Wuyb, Wuyb, Wuyb, Wuyb, Wuyb, Mybd^Bryb, Mybd, Mybd, Mybd, Mybd^Bryb, Wuyb, Wuyb, Wuyb, Wuyb, Wuyb, Wuyb, Wuyb, Wuyb, Wuyb, Wuyb, Wuyb, Wuyb, Woby, Wuyb, Wuyb, Wuyb, Wuyb, Wuyb, Wuyb, Wuyb, Wuyb, Woby, Wuyb, Woby, Woby, Woby, Wuyb, Wuyb, Wuyb, Wuyb, Wuyb, Wuyb, Wuyb, Wuyb
Wuyb, Wuyb, Wuyb, Wuyb, Wuyb, Wuyb, Wuyb, Wuyb, Wuyb, Mybd, Btyb, Btyb, Btym^Sy|, Btyb, Btyb, Mybd, Wuyb, Wuyb, Wuyb, Wuyb, Wuyb, Wuyb, Wuyb, Wuyb, Wuyb, Wuyb, Wuyb, Wuyb, Wuyb, Wuyb, Wuyb, Wuyb, Wuyb, Wuyb, Wuyb, Woby, Woby, Woby, Wuyb, Woby, Woby, Wuyb, Wuyb, Wuyb, Wuyb, Wuyb, Wuyb, Wuyb, Wuyb
Wuyb, Wuyb, Wuyb, Wuyb, Wuyb, Wuyb, Wuyb, Wuyb, Wuyb, Wuyb, Btym, Btym, Btym^Sy|, Btym, Btym, Wuyb, Wuyb, Wuyb, Wuyb, Wuyb, Wuyb, Wuyb, Wuyb, Wuyb, Wuyb, Wuyb, Wuyb, Wuyb, Wuyb, Wuyb, Wuyb, Wuyb, Wuyb, Wuyb, Woby, Woby, Woby, Wuyb, Wuyb, Woby, Woby, Wuyb, Wuyb, Wuyb, Wuyb, Wuyb, Wuyb, Wuyb, Wuyb
Wuyb, Wuyb, Wuyb, Wuyb, Wuyb, Wuyb, Wuyb, Wuyb, Wuyb, Wuyb, Btym, Btym, Btym^Sy|, Btym, Btym, Wuyb, Wuyb, Wuyb, Wuyb, Wuyb, Wuyb, Wuyb, Wuyb, Wuyb, Wuyb, Wuyb, Wuyb, Wuyb, Wuyb, Wuyb, Wuyb, Wuyb, Woby, Woby^Gyw, Wuyb, Wuyb, Wuyb, Woby, Wuyb, Wuyb, Woby, Woby, Woby, Wuyb, Wuyb, Wuyb, Wuyb, Wuyb, Wuyb
Wuyb, Wuyb, Wuyb, Wuyb, Wuyb, Wuyb, Wuyb, Wuyb, Wuyb, Wuyb, Btym^Xo, Btym, Btym^Xo, Btym, Btym^Xo, Wuyb, Wuyb, Wuyb, Wuyb, Wuyb, Wuyb, Wuyb, Wuyb, Wuyb, Wuyb, Wuyb, Wuyb, Wuyb, Wuyb, Wuyb, Wuyb, Woby, Wuyb, Wuyb, Wuyb, Wuyb, Wuyb, Wuyb, Wuyb, Wuyb, Wuyb, Wuyb, Wuyb, Wuyb, Wuyb, Wuyb, Wuyb, Wuyb, Wuyb
Wuyb, Wuyb, Wuyb, Wuyb, Wuyb, Wuyb, Wuyb, Wuyb, Wuyb, Wuyb, Wuyb, Btym^Xo, Btym^Sy|, Btym^Xo, Wuyb, Wuyb, Wuyb, Wuyb, Wuyb, Wuyb, Wuyb, Wuyb, Wuyb, Btym, Btym^Xo, Btym, Wuyb, Wuyb, Wuyb, Wuyb, Wuyb, Wuyb, Wuyb, Wuyb, Wuyb, Wuyb, Wuyb, Wuyb, Wuyb, Wuyb, Wuyb, Wuyb, Wuyb, Wuyb, Wuyb, Wuyb, Wuyb, Wuyb, Wuyb
Wuyb, Wuyb, Wuyb, Wuyb, Wuyb, Wuyb, Wuyb, Wuyb, Wuyb, Wuyb, Wuyb, Btym, Wuy, Btym, Wuyb, Wuyb, Wuyb, Wuyb, Wuyb, Wuyb, Wuyb, Wuyb, Wuyb, Btym, Btym^Sy|, Btym, Wuyb, Wuyb, Wuyb, Wuyb, Wuyb, Wuyb, Wuyb, Wuyb, Wuyb, Wuyb, Wuyb, Wuyb, Wuyb, Wuyb, Wuyb, Wuyb, Wuyb, Wuyb, Wuyb, Wuyb, Wuyb, Wuyb, Wuyb
Wuyb, Wuyb, Wuyb, Wuyb, Wuyb, Wuyb, Wuyb, Wuyb, Wuyb, Wuyb, Wuy, Wuy, Wuy, Wuy, Wuy, Wuyb, Wuyb, Wuyb, Wuyb, Wuyb, Wuyb, Wuyb, Wuyb, Btym, Btym^Sy|, Btym, Wuyb, Wuyb, Wuyb, Wuyb, Wuyb, Wuyb, Wuyb, Wuyb, Wuyb, Wuyb, Wuyb, Wuyb, Wuyb, Wuyb, Wuyb, Wuyb, Wuyb, Wuyb, Wuyb, Wuyb, Wuyb, Wuyb, Wuyb
Wuyb, Wuyb, Wuyb, Wuyb, Wuyb, Wuyb, Wuyb, Wuyb, Wuyb, Wuyb, Wuyb, Wuy, Wuyb, Wuy, Wuyb, Wuyb, Wuyb, Wuyb, Wuyb, Wuyb, Wuyb, Wuyb, Btym, Btym, Btym^Sy|, Btym, Btym, Wuyb, Wuyb, Wuyb, Wuyb, Wuyb, Woby, Wuyb, Wuyb, Wuyb, Wuyb, Wuyb, Wuyb, Wuyb, Wuyb, Wuyb, Wuyb, Wuyb, Wuyb, Wuyb, Wuyb, Wuyb, Wuyb
Wuyb, Wuyb, Wuyb, Wuyb, Wuyb, Wuyb, Wuyb, Wuyb, Wuyb, Wuyb, Wuyb, Wuyb, Wuyb, Wuyb, Woby, Woby, Woby, Wuyb, Wuyb, Wuyb, Wuyb, Wuyb, Btym, Btym, Btym^Sy|, Btym, Btym, Wuyb, Wuyb, Wuyb, Wuyb, Wuyb, Woby, Woby, Woby, Wuyb, Wuyb, Wuyb, Wuyb, Wuyb, Wuyb, Wuyb, Wuyb, Wuyb, Wuyb, Wuyb, Wuyb, Wuyb, Wuyb
Wuyb, Wuyb, Wuyb, Wuyb, Wuyb, Wuyb, Wuyb, Wuyb, Wuyb, Wuyb, Wuyb, Wuyb, Wuyb, Wuyb, Woby, Woby, Wuyb, Woby, Wuyb, Wuyb, Wuyb, Woby, Woby, Btym, Woby, Btym, Woby, Wuyb, Wuyb, Wuyb, Wuyb, Wuyb, Wuyb, Woby, Woby, Wuyb, Wuyb, Wuyb, Wuyb, Wuyb, Wuyb, Wuyb, Wuyb, Wuyb, Wuyb, Wuyb, Wuyb, Wuyb, Wuyb
Wuyb, Wuyb, Wuyb, Wuyb, Wuyb, Wuyb, Wuyb, Wuyb, Wuyb, Wuyb, Wuyb, Wuyb, Wuyb, Wuyb, Wuyb, Woby, Wuyb, Woby, Woby, Woby, Woby, Woby, Woby, Woby, Woby, Woby, Wuyb, Wuyb, Wuyb, Wuyb, Wuyb, Wuyb, Woby, Woby^Gyw, Wuyb, Wuyb, Wuyb, Wuyb, Wuyb, Wuyb, Wuyb, Wuyb, Wuyb, Wuyb, Wuyb, Wuyb, Wuyb, Wuyb, Wuyb
Wuyb, Wuyb, Wuyb, Wuyb, Wuyb, Wuyb, Wuyb, Wuyb, Wuyb, Wuyb, Wuyb, Wuyb, Wuyb, Wuyb, Wuyb, Wuyb, Wuyb, Wuyb, Wuyb, Wuyb, Wuyb, Woby, Woby, Woby, Woby, Woby, Woby, Wuyb, Woby, Wuyb, Woby, Woby, Wuyb, Wuyb, Wuyb, Wuyb, Wuyb, Wuyb, Wuyb, Wuyb, Wuyb, Wuyb, Wuyb, Wuyb, Wuyb, Wuyb, Wuyb, Wuyb, Wuyb
Wuyb, Wuyb, Wuyb, Wuyb, Wuyb, Wuyb, Wuyb, Wuyb, Wuyb, Wuyb, Wuyb, Wuyb, Wuyb, Wuyb, Wuyb, Wuyb, Wuyb, Wuyb, Wuyb, Wuyb, Woby, Woby, Woby, Woby, Woby, Woby, Wuyb, Woby, Wuyb, Woby, Wuyb, Wuyb, Wuyb, Wuyb, Wuyb, Wuyb, Wuyb, Wuyb, Wuyb, Wuyb, Wuyb, Wuyb, Wuyb, Wuyb, Wuyb, Wuyb, Wuyb, Wuyb, Wuyb
Wuyb, Wuyb, Wuyb, Wuyb, Wuyb, Wuyb, Wuyb, Wuyb, Wuyb, Wuyb, Wuyb, Wuyb, Wuyb, Wuyb, Wuyb, Wuyb, Wuyb, Wuyb, Wuyb, Wuyb, Woby, Woby, Wuyb, Wuyb, Wuyb, Wuyb, Wuyb, Wuyb, Wuyb, Wuyb, Wuyb, Wuyb, Wuyb, Wuyb, Wuyb, Wuyb, Wuyb, Wuyb, Wuyb, Wuyb, Wuyb, Wuyb, Wuyb, Wuyb, Wuyb, Wuyb, Wuyb, Wuyb, Wuyb
Wuyb, Wuyb, Wuyb, Wuyb, Wuyb, Wuyb, Wuyb, Wuyb, Wuyb, Wuyb, Wuyb, Wuyb, Wuyb, Wuyb, Wuyb, Wuyb, Wuyb, Wuyb, Wuyb, Woby, Woby, Wuyb, Wuyb, Wuyb, Wuyb, Wuyb, Wuyb, Wuyb, Wuyb, Wuyb, Wuyb, Wuyb, Wuyb, Wuyb, Wuyb, Wuyb, Wuyb, Wuyb, Wuyb, Wuyb, Wuyb, Wuyb, Wuyb, Wuyb, Wuyb, Wuyb, Wuyb, Wuyb, Wuyb
Wuyb, Wuyb, Wuyb, Wuyb, Wuyb, Wuyb, Wuyb, Wuyb, Wuyb, Wuyb, Wuyb, Wuyb, Wuyb, Wuyb, Wuyb, Wuyb, Wuyb, Wuyb, Woby, Woby, Woby, Wuyb, Wuyb, Wuyb, Wuyb, Wuyb, Wuyb, Wuyb, Wuyb, Wuyb, Wuyb, Wuyb, Wuyb, Wuyb, Wuyb, Wuyb, Wuyb, Wuyb, Wuyb, Wuyb, Wuyb, Wuyb, Wuyb, Wuyb, Wuyb, Wuyb, Wuyb, Wuyb, Wuyb
Wuyb, Wuyb, Wuyb, Wuyb, Wuyb, Wuyb, Wuyb, Wuyb, Wuyb, Woby, Woby, Woby, Woby, Wuyb, Wuyb, Wuyb, Wuyb, Wuyb, Woby, Woby, Woby, Woby, Woby, Woby, Woby, Wuyb, Wuyb, Wuyb, Wuyb, Wuyb, Woby, Wuyb, Woby, Wuyb, Wuyb, Wuyb, Wuyb, Wuyb, Wuyb, Wuyb, Wuyb, Wuyb, Wuyb, Wuyb, Wuyb, Wuyb, Wuyb, Wuyb, Wuyb
Wuyb, Wuyb, Wuyb, Wuyb, Wuyb, Wuyb, Wuyb, Wuyb, Wuyb, Wuyb, Wuyb, Wuyb, Wuyb, Woby, Wuyb, Wuyb, Wuyb, Wuyb, Wuyb, Woby, Woby, Woby, Woby, Kydy, Cydy, Woby, Woby, Wuyb, Woby, Woby, Wuyb, Woby, Woby, Wuyb, Wuyb, Wuyb, Wuyb, Wuyb, Wuyb, Wuyb, Wuyb, Wuyb, Wuyb, Wuyb, Wuyb, Wuyb, Wuyb, Wuyb, Wuyb
Wuyb, Wuyb, Wuyb, Wuyb, Wuyb, Wuyb, Wuyb, Wuyb, Wuyb, Wuyb, Wuyb, Wuyb, Woby, Woby, Wuyb, Wuyb, Wuyb, Wuyb, Wuyb, Wuyb, Woby, Woby, Woby, Cydy, Woby, Woby, Woby, Woby, Wuyb, Wuyb, Wuyb, Wuyb, Woby, Wuyb, Wuyb, Wuyb, Wuyb, Wuyb, Wuyb, Wuyb, Wuyb, Wuyb, Wuyb, Wuyb, Wuyb, Wuyb, Wuyb, Wuyb, Wuyb
Wuyb, Wuyb, Wuyb, Wuyb, Wuyb, Wuyb, Wuyb, Wuyb, Wuyb, Wuyb, Wuyb, Wuyb, Woby, Wuyb, Woby, Wuyb, Wuyb, Wuyb, Woby, Woby, Woby, Woby, Woby, Woby, Woby, Woby, Woby, Woby, Woby, Wuyb, Woby, Woby, Wuyb, Wuyb, Wuyb, Wuyb, Wuyb, Wuyb, Wuyb, Wuyb, Wuyb, Wuyb, Wuyb, Wuyb, Wuyb, Wuyb, Wuyb, Wuyb, Wuyb
Wuyb, Wuyb, Wuyb, Wuyb, Wuyb, Wuyb, Wuyb, Wuyb, Woby, Wuyb, Wuyb, Wuyb, Wuyb, Woby, Woby, Woby, Woby, Woby, Woby, Woby, Woby, Woby, Woby, Woby, Woby, Woby, Woby, Woby, Woby, Woby, Wuyb, Wuyb, Wuyb, Wuyb, Wuyb, Wuyb, Wuyb, Wuyb, Wuyb, Wuyb, Wuyb, Wuyb, Wuyb, Wuyb, Wuyb, Wuyb, Wuyb, Wuyb, Wuyb
Wuyb, Wuyb, Wuyb, Wuyb, Wuyb, Wuyb, Wuyb, Woby, Wuyb, Woby, Woby, Wuyb, Wuyb, Wuyb, Woby, Woby, Woby, Woby, Woby, Wuy, Woby, Woby, Woby, Wuy, Wuy, Woby, Woby, Wuy, Woby, Woby, Wuyb, Wuyb, Woby, Wuyb, Woby, Woby, Woby, Wuyb, Wuyb, Wuyb, Wuyb, Wuyb, Wuyb, Wuyb, Wuyb, Wuyb, Wuyb, Wuyb, Wuyb
Wuyb, Wuyb, Wuyb, Wuyb, Wuyb, Wuyb, Wuyb, Wuyb, Wuyb, Wuyb, Wuyb, Woby, Woby, Woby, Woby, Wuy, Woby, Woby, Woby, Woby, Woby, Woby, Woby, Woby, Woby, Woby, Woby, Woby, Woby, Woby, Woby, Woby, Wuyb, Woby, Wuyb, Wuyb, Wuyb, Woby, Woby, Woby, Wuyb, Wuyb, Wuyb, Wuyb, Wuyb, Wuyb, Wuyb, Wuyb, Wuyb
Wuyb, Wuyb, Wuyb, Wuyb, Wuyb, Wuyb, Wuyb, Wuyb, Wuyb, Wuyb, Woby, Woby, Wuyb, Woby, Woby, Woby, Woby, Wuy, Woby, Woby, Wuy, Woby, Gd^Fyok, Woby, Woby, Woby, Woby, Woby, Woby, Woby, Wuyb, Woby, Wuyb, Wuyb, Wuyb, Wuyb, Wuyb, Woby, Wuyb, Woby, Wuyb, Wuyb, Wuyb, Wuyb, Wuyb, Wuyb, Wuyb, Wuyb, Wuyb
Wuyb, Wuyb, Wuyb, Wuyb, Wuyb, Wuyb, Wuyb, Wuyb, Wuyb, Woby, Wuyb, Wuyb, Wuyb, Woby, Woby, Woby, Woby, Wuy, Woby, Woby, Woby, Woby, Woby, Woby, Wuy, Wuy, Woby, Woby, Woby, Wuyb, Wuyb, Wuyb, Wuyb, Wuyb, Wuyb, Wuyb, Wuyb, Wuyb, Wuyb, Wuyb, Wuyb, Wuyb, Wuyb, Wuyb, Wuyb, Wuyb, Wuyb, Wuyb, Wuyb
Wuyb, Wuyb, Wuyb, Wuyb, Wuyb, Wuyb, Wuyb, Wuyb, Wuyb, Woby, Woby, Wuyb, Wuyb, Wuyb, Wuyb, Woby, Woby, Woby, Woby, Woby, Woby, Woby, Woby, Woby, Wuy, Woby, Woby, Woby, Wuyb, Woby, Woby, Wuyb, Wuyb, Wuyb, Wuyb, Wuyb, Wuyb, Wuyb, Wuyb, Wuyb, Wuyb, Wuyb, Wuyb, Wuyb, Wuyb, Wuyb, Wuyb, Wuyb, Wuyb
Wuyb, Wuyb, Wuyb, Wuyb, Wuyb, Wuyb, Wuyb, Wuyb, Wuyb, Wuyb, Wuyb, Wuyb, Wuyb, Wuyb, Wuyb, Woby, Woby, Woby, Woby, Wuy, Wuy, Woby, Woby, Woby, Woby, Wuy, Woby, Woby, Wuyb, Wuyb, Wuyb, Woby, Woby, Woby, Wuyb, Wuyb, Wuyb, Wuyb, Wuyb, Wuyb, Wuyb, Wuyb, Wuyb, Wuyb, Wuyb, Wuyb, Wuyb, Wuyb, Wuyb
Wuyb, Wuyb, Wuyb, Wuyb, Wuyb, Wuyb, Wuyb, Wuyb, Wuyb, Wuyb, Wuyb, Wuyb, Wuyb, Wuyb, Wuyb, Wuyb, Wuyb, Woby, Woby, Woby, Woby, Woby, Woby, Woby, Woby, Woby, Wuyb, Wuyb, Wuyb, Wuyb, Wuyb, Wuyb, Wuyb, Wuyb, Wuyb, Wuyb, Wuyb, Wuyb, Wuyb, Wuyb, Wuyb, Wuyb, Wuyb, Wuyb, Wuyb, Wuyb, Wuyb, Wuyb, Wuyb
Wuyb, Wuyb, Wuyb, Wuyb, Wuyb, Wuyb, Wuyb, Wuyb, Wuyb, Wuyb, Wuyb, Wuyb, Wuyb, Wuyb, Wuyb, Wuyb, Wuyb, Wuyb, Wuyb, Woby, Woby, Woby, Wuyb, Wuyb, Wuyb, Wuyb, Wuyb, Wuyb, Wuyb, Wuyb, Wuyb, Wuyb, Wuyb, Wuyb, Wuyb, Wuyb, Wuyb, Wuyb, Wuyb, Wuyb, Wuyb, Wuyb, Wuyb, Wuyb, Wuyb, Wuyb, Wuyb, Wuyb, Wuyb
Wuyb, Wuyb, Wuyb, Wuyb, Wuyb, Wuyb, Wuyb, Wuyb, Wuyb, Wuyb, Wuyb, Wuyb, Wuyb, Wuyb, Wuyb, Wuyb, Wuyb, Wuyb, Wuyb, Wuyb, Wuyb, Wuyb, Wuyb, Wuyb, Wuyb, Wuyb, Wuyb, Wuyb, Wuyb, Wuyb, Wuyb, Wuyb, Wuyb, Wuyb, Wuyb, Wuyb, Wuyb, Wuyb, Wuyb, Wuyb, Wuyb, Wuyb, Wuyb, Wuyb, Wuyb, Wuyb, Wuyb, Wuyb, Wuyb
Wuyb, Wuyb, Wuyb, Wuyb, Wuyb, Wuyb, Wuyb, Wuyb, Wuyb, Wuyb, Wuyb, Wuyb, Wuyb, Wuyb, Wuyb, Wuyb, Wuyb, Wuyb, Wuyb, Wuyb, Wuyb, Wuyb, Wuyb, Wuyb, Wuyb, Wuyb, Wuyb, Wuyb, Wuyb, Wuyb, Wuyb, Wuyb, Wuyb, Wuyb, Wuyb, Wuyb, Wuyb, Wuyb, Wuyb, Wuyb, Wuyb, Wuyb, Wuyb, Wuyb, Wuyb, Wuyb, Wuyb, Wuyb, Wuyb
