border_size=1
usage=map

Mybd, Mybd, Mybd^Bryb, Mybd, Mybd^Eyt, Mybd, Mybd, Mybd^Eyt, Mybd, Mybd, Mybd, Mybd, Mybd, Mybd, Wuy, Wuy, Wuy, Woby, Woby, Woby, Woby, Woby, Woby, Woby, Woby, Woby, Woby
Mybd, Mybd, Mybd, Mybd, Mybd^Eyt, Mybd^Eyt, Mybd^Eyt, Mybd, Mybd, Mybd^Eyt, Mybd, Mybd, Mybd, Wuy, Wuy, Wuy, Wuy, Woby, Woby, Woby, Woby, Woby, Woby, Woby, Woby, Woby, Woby
Mybd, Mybd^Eyt, Mybd, Mybd^Eyt, Mybd^Eyt, Mybd^Eyt, Mybd^Eyt, Mybd^Eyt, Mybd, Mybd, Mybd^Eyt, Mybd, Mybd^Bryb, Wuy, Wuy, Wuy, Woby, Woby, Woby, Woby, Woby, Woby, Woby, Gg^Fet, Woby, Woby, Woby
Mybd, Mybd, Mybd, Mybd, Mybd^Eyt, Mybd^Eyt, Mybd, Mybd, Mybd, Mybd, Mybd, Mybd, Wuy, Wuy, Wuy, Wuy, Woby, Woby, Woby, Woby, Woby, Woby, Woby, Woby, Woby, Woby, Woby
Mybd, Mybd, Mybd^Eyt, Mybd, Mybd, Mybd, Mybd, Mybd^Eyt, Mybd, Mybd, Wuy, Wuy, Wuy, Wuy, Urfz, Mybd, Woby, Woby, Woby, Woby, Woby, Woby, Woby, Woby, Woby, Woby, Woby
Mybd, Mybd, Mybd, Mybd, Mybd, Mybd, Mybd, Mybd, Wuy, Wuy, Wuy, Wuy, Urfz, Urfz^Gyw, Mybd^Gyw, Woby, Woby, Woby, Woby, Woby, Wuy, Woby, Wuy, Woby, Woby, Woby, Woby
Wuy, Mybd, Wuy, Mybd^Bryb, Wuy, Mybd, Mybd, Mybd, Wuy, Wuy, Wuy, Wuy, Mybd, Urfz^Gywo, Wuy, Wuy, Wuy, Wuy, Wuy, Wuy, Wuy, Wuy, Wuy, Wuy, Wuy, Wuy, Wuy
Wuy, Wuy, Wuy, Wuy, Wuy, Mybd, Mybd, Mybd, Wuy, Wuy, Wuy, Wuy, Mybd, Urfz, Wuy, Wuy, Wuy, Wuy, Wuy, Wuy, Wuy, Wuy, Wuy, Wuy, Wuy, Wuy, Wuy
Wuy, Wuy, Wuy, Wuy, Wuy, Wuy, Mybd, Mybd, Wuy, Wuy, Mybd, Mybd, Mybd, Mybd, Wuy, Wuy, Wuy, Wuy, Wuy, Wuy, Fypd, Fypd, Fypd, Wuy, Wuy, Wuy, Wuy
Wuy, Wuy, Wuy, Wuy, Wuy, Mybd, Mybd, Mybd, Urfz^Bryb, Wuy, Urfz, Urfz, Mybd, Mybd, Wuy, Wuy, Wuy, Wuy, Wuy, Mybd^Bryb, Fypd, Fypd^Fyod, Fypd^Fyod, Fypd, Wuy, Wuy, Wuy
Wuy, Wuy, Wuy, Wuy, Wuy, Mybd, Mybd, Urfz, Urfz, Urfz, Urfz, Mybd, Mybd, Wuy, Wuy, Wuy, Wuy, Wuy, Wuy, Mybd, Fypd, Fypd^Fyod, Fypd^Fyod, Fypd, Wuy, Wuy, Wuy
Wuy, Wuy, Wuy, Wuy, Wuy, Urfz, Urfz, Mybd, Urfz, Urfz, Urfz, Mybd, Mybd, Wuy, Wuy, Wuy, Wuy, Wuy, Mybd^Bryb, Mybd, Fypd, Fypd^Fyod, Fypd, Fypd, Mybd^Bryb, Wuy, Wuy
Wuy, Wuy, Wuy, Wuy, Wuy, Urfz, Urfz, Urfz, Urfz, Pryf, Urfz, Urfz, Urfz, Urfz^Bryb, Wuy, Wuy, Wuy, Wuy, Mybd, Mybd, Fypd, Fypd, Mybd, Fypd, Mybd, Wuy, Wuy
Wuy, Wuy, Urfz^Bryb, Wuy, Urfz, Urfz, Urfz, Urb, Urb, Urb, Urb, Urfz, Urb, Urfz, Urfz, Wuy, Wuy, Wuy, Fypd, Fypd, Fypd, Fypd, Wuy, Mybd, Wuy, Wuy, Wuy
Mybd, Urfz, Mybd, Urfz, Urfz, Pryf, Urb, Urb, Urb, Pryf, Urb, Urb, Urb, Pryf, Urfz, Urfz, Urfz, Mybd, Mybd, Fypd, Fypd, Wuy, Wuy, Wuy, Wuy, Wuy, Wuy
Mybd, Mybd, Urfz, Urfz, Urb, Urb, Urb, Pryf, Urb, Urb, Urb, Pryf, Urb, Urfz, Urfz, Urfz, Mybd, Urfz, Mybd, Mybd, Wuy, Wuy, Wuy, Wuy, Wuy, Wuy, Wuy
Mybd, Urfz, Urfz, Urfz, Urfz, Urb, Urb, Urb, Urb, Xzsf, Urb, Urb, Urb, Urb, Urb, Urfz, Mybd, Mybd, Mybd, Mybd, Wuy, Wuy, Wuy, Wuy, Wuy, Wuy, Wuy
Wuy, Mybd, Mybd, Urfz, Urb, Urb, Urb, Pryf, Urb, Urb, Urb, Pryf, Urb, Urb, Urfz, Urfz, Mybd, Mybd^Bryb, Wuy, Wuy, Wuy, Wuy, Wuy, Wuy, Wuy, Wuy, Wuy
Wuy, Wuy, Mybd, Urfz, Urfz, Pryf, Urb, Urb, Urb, Pryf, Urb, Urb, Urfz, Pryf, Urfz, Mybd, Wuy, Wuy, Wuy, Wuy, Wuy, Wuy, Wuy, Wuy, Wuy, Wuy, Wuy
Wuy, Wuy, Wuy, Urfz, Mybd, Urfz, Urfz, Urfz, Urfz, Urb, Urfz, Urb, Urfz, Urfz, Mybd, Mybd, Mybd, Wuy, Mybd^Bryb, Wuy, Mybd, Wuy, Wuy, Wuy, Wuy, Wuy, Wuy
Wuy, Wuy, Wuy, Wuy, Mybd, Urfz, Mybd, Urfz, Urfz, Pryf, Urfz, Urfz, Urfz, Urfz, Mybd, Mybd, Fypd, Mybd, Fypd, Fypd, Mybd, Fypd, Fypd^Bryb, Wuy, Wuy, Wuy, Wuy
Wuy, Wuy, Wuy, Wuy, Mybd^Bryb, Mybd, Mybd, Mybd, Mybd, Urfz, Mybd, Urfz, Urfz, Mybd, Mybd, Mybd, Fypd, Fypd, Fypd, Fypd^Fyod, Fypd^Fyod, Fypd^Fyod, Fypd, Wuy, Wuy, Wuy, Wuy
Wuy, Wuy, Wuy, Wuy, Wuy, Wuy, Wuy, Mybd, Mybd, Mybd, Mybd, Urfz, Mybd, Urfz, Mybd, Mybd, Mybd, Fypd, Fypd, Fypd^Fyod, Fypd, Fypd^Fyod, Fypd^Fyod, Fypd, Wuy, Wuy, Wuy
Wuy, Wuy, Wuy, Wuy, Wuy, Wuy, Wuy, Wuy, Wuy, Wuy, Wuy, Mybd, Mybd, Mybd, Mybd, Mybd, Mybd, Mybd^Bryb, Mybd, Fypd, Mybd, Fypd, Fypd, Fypd^Fyod, Wuy, Wuy, Wuy
Wuy, Wuy, Wuy, Wuy, Wuy, Wuy, Wuy, Wuy, Wuy, Wuy, Wuy, Mybd^Bryb, Mybd, Mybd, Mybd^Bryb, Wuy, Wuy, Wuy, Wuy, Mybd, Wuy, Fypd^Bryb, Wuy, Wuy, Wuy, Wuy, Wuy
Wuy, Wuy, Wuy, Wuy, Wuy, Wuy, Wuy, Wuy, Wuy, Wuy, Wuy, Wuy, Mybd, Mybd, Mybd, Wuy, Wuy, Wuy, Wuy, Wuy, Wuy, Wuy, Wuy, Wuy, Wuy, Wuy, Wuy
Wuy, Wuy, Wuy, Wuy, Wuy, Wuy, Wuy, Wuy, Wuy, Wuy, Wuy, Wuy, Mybd^Bryb, Mybd, Mybd^Gye, Mybd^Gye, Wuy, Wuy, Wuy, Wuy, Wuy, Wuy, Wuy, Wuy, Wuy, Wuy, Wuy
Wuy, Wuy, Wuy, Wuy, Wuy, Wuy, Wuy, Wuy, Wuy, Wuy, Wuy, Wuy, Wuy, Mybd^Gye, Mybd, Mybd, Wuy, Wuy, Wuy, Wuy, Wuy, Wuy, Wuy, Wuy, Wuy, Wuy, Wuy
Wuy, Wuy, Wuy, Wuy, Wuy, Wuy, Wuy, Wuy, Wuy, Wuy, Wuy, Wuy, Wuy, Mybd, Mybd, Mybd, Wuy, Wuy, Wuy, Wuy, Wuy, Wuy, Wuy, Wuy, Wuy, Wuy, Wuy
Wuy, Wuy, Wuy, Wuy, Wuy, Wuy, Wuy, Wuy, Wuy, Wuy, Wuy, Wuy, Wuy, Mybd, Mybd, Mybd, Wuy, Wuy, Wuy, Wuy, Wuy, Wuy, Wuy, Wuy, Wuy, Wuy, Wuy
