Gll^Fp, Gll^Fp, Xu, Xu, Xu, Xu, Woby, Woby, Woby, Woby, Woby, Woby, Woby, Woby, Woby, Xu, Xu, Xu, Xu, Gll^Fmw, Gll^Fmw, Gll^Fmw, Gll^Fp, Gll^Fp, Gs, Gs, Gll^Fp, Hh, Hh, Hh, Mm, Mm, Mm^Xm, Mm^Xm, Mm^Xm, Mm^Xm, Ms^Xm, Ms^Xm, Ms^Xm, Ms^Xm, Ms^Xm, Ai, Ms^Xm, Ms^Xm, Ms^Xm, Ms^Xm, Ms, Ha, Ha, Ha, Spay, Ha, Ms, Ms, Ms, Ms, Ms^Xm, Ms^Xm, Ms^Xm
Gs^Fms, Xu, Xu, Xu, Woby, Woby, Woby, Woby, Woby, Woby, Woby, Woby, Woby, Woby, Woby, Woby, Woby, Xu, Xu, Xu, Gll, Gll, Gll^Fmw, Gll^Fp, Gs^Fds, Gs^Fms, Gll^Fp, Hh, Gs^Fms, Hh^Fmw, Hh, Mm, Hh^Fp, Mm, Mm, Mm^Xm, Mm^Xm, Ms^Xm, Ms^Xm, Ms^Xm, Ms^Xm, Ms^Xm, Ms, Ms^Xm, Ms, Ms, Ha, Ha, Ha, Spay, Ai, Ha, Ha, Ms, Ha, Ms, Ms, Ms^Xm, Ms
Gs, Xu, Xu, Woby, Woby, Woby, Woby, Woby, Woby, Woby, Woby, Woby, Woby, Woby, Woby, Woby, Woby, Woby, Xu, Xu, Gll^Fmw, Gll^Fmw, Gll^Fp, Gs^Fms, Gs^Fds, Gll^Fp, Gs^Fms, Gs^Fds, Gll^Fp, Hh^Fmw, Hh^Fms, Hh^Fp, Hh^Fms, Hh^Fp, Mm, Mm^Xm, Mm^Xm, Ms^Xm, Ms^Xm, Ms, Ms, Ms, Ms, Ms, Tyb, Ms, Ms, Ha, Spay, Spay, Ai, Ha, Ha, Ms, Ha, Ms, Xyui, Ms, Xyui
Gs, Xu, Xu, Woby, Woby, Woby, Woby, Woby, Woby, Woby, Woby, Woby, Woby, Woby, Woby, Woby, Woby, Woby, Xu, Xu, Gll^Fmw, Gll^Fp, Gs^Fms, Gs^Fms, Gs^Fds, Gs^Fds, Gs^Fms, Gs^Fms, Gs, Gll^Fmw, Gll^Fmw, Gs^Fds, Gs^Fms, Hh, Hh^Fmw, Mm, Mm^Xm, Mm^Xm, Ms^Xm, Ms, Ms^Xm, Ms, Ms, Tyb, Ayb, Tyb, Ms, Ha, Spay, Ai, Spay, Spay, Spay, Spay, Xyui, Xyui, Xyui, Xyui, Xyui
Gll^Fp, Xu, Xu, Woby, Woby, Woby, Woby, Woby, Woby, Woby, Woby, Woby, Woby, Woby, Woby, Woby, Woby, Woby, Xu, Xu, Gll^Fmw, Gll^Fmw, Gll^Fp, Gs^Fms, Gll^Fp, Gs^Fds, Gs^Fms, Gll^Fmw, Gll^Fmw, Gll^Fmw, Gll^Fdw, Gs, Gll^Fmw, Hh^Fp, Hh^Fdw, Mm, Mm, Mm^Xm, Mm^Xm, Ms^Xm, Ms^Xm, Ms, Ms, Tyb, Tyb, Tyb, Spay, Ha, Ai, Spay, Ai, Ai, Ai, Ha, Xyui, Xyui, Xyui, Xyui, Xyui
Gll^Fp, Xu, Xu, Woby, Woby, Woby, Woby, Woby, Woby, Woby, Xu, Woby, Woby, Woby, Woby, Woby, Woby, Woby, Xu, Xu, Gll^Fdw, Gll, Gll^Fdw, Gll^Fmw, Gll^Fmw, Gll^Fp, Gs, Gll^Fp, Gll^Fmw, Gll^Fmw, Gll, Gs, Gll^Fdw, Gll^Fmw, Gll^Fmw, Hh^Fdw, Hh, Mm, Mm^Xm, Ms^Xm, Ms, Ms^Xm, Ms^Xm, Ms, Ms, Ms, Aa, Spay, Spay, Spay, Spay, Ai, Spay, Xyui, Xyui, Xyui, Qxyi, Qxyi, Qxyi
Gll^Fp, Xu, Xu, Woby, Woby, Woby, Woby, Woby, Woby, Woby, Woby, Woby, Woby, Woby, Woby, Woby, Woby, Woby, Xu, Xu, Gll^Fp, Gll^Fp, Gs^Fms, Gll^Fp, Gll^Fmw, Gll^Fmw, Gs^Fms, Gs, Gll^Fmw, Gll^Fmw, Gll^Fmw, Gll, Gs, Gll, Hh^Fdw, Hh, Mm, Mm^Xm, Ms^Xm, Ms^Xm, Ms^Xm, Ms^Xm, Ms, Ms, Ai, Ai, Spay, Spay, Ha, Spay, Ai, Spay, Xyui, Xyui, Xyui, Xyui, Qxyi, Qxyi, Qxyi
Gs^Fms, Xu, Xu, Woby, Woby, Woby, Woby, Woby, Woby, Woby, Woby, Woby, Woby, Woby, Woby, Woby, Woby, Woby, Xu, Xu, Gll^Fp, Gs^Fms, Gs^Fds, Gs^Fds, Gll^Fmw, Gll^Fmw, Gll^Fp, Gll^Fp, Gs^Fms, Gll^Fmw, Gll, Gll^Fmw, Gll^Fdw, Gll^Fdw, Hh^Fmw, Hh^Fmw, Mm^Xm, Mm^Xm, Ms^Xm, Ms^Xm, Ms^Xm, Ms, Ms, Ha, Ai, Ha, Spay, Ha, Ha, Spay, Ai, Ha, Xyui, Xyui, Spay, Qxyi, Qxyi, Qxyi, Qxyi
Gs^Fds, Xu, Xu, Woby, Woby, Woby, Woby, Woby, Woby, Woby, Woby, Woby, Woby, Woby, Woby, Woby, Woby, Woby, Xu, Xu, Gs^Fds, Gs^Fms, Gs^Fms, Gs, Gll^Fmw, Gs^Fds, Gs^Fms, Gll^Fp, Gs^Fds, Gs, Gll^Fp, Gll^Fmw, Hh^Fp, Hh^Fmw, Mm, Mm, Mm^Xm, Mm^Xm, Ms^Xm, Ms^Xm, Ms, Ms, Ha, Ha, Ai, Ha, Spay, Ai, Ha, Spay, Ai, Ha, Spay, Spay, Spay, Qxyi, Qxyi, Qxyi, Qxyi
Gs^Fds, Xu, Xu, Woby, Woby, Woby, Woby, Woby, Woby, Woby, Woby, Woby, Woby, Woby, Woby, Woby, Woby, Woby, Xu, Xu, Gs, Gs^Fms, Gs^Fds, Gll^Fmw, Gll^Fdw, Gll^Fmw, Gs^Fds, Gs^Fms, Gs^Fms, Gs^Fds, Gll^Fp, Gll^Fmw, Hh^Fp, Hh^Fp, Mm, Mm, Mm^Xm, Ms^Xm, Ms^Xm, Ms, Ms, Ha, Ha, Ha, Spay, Spay, Ha, Ai, Ai, Spay, Spay, Spay, Ai, Ai, Xyui, Xyui, Xyui, Qxyi, Qxyi
Gg, Xu, Xu, Xu, Xu, Woby, Woby, Woby, Woby, Woby, Woby, Woby, Woby, Woby, Woby, Woby, Xu, Xu, Xu, Xu, Gll^Fp, Gs^Fds, Gs^Fms, Gll^Fmw, Gll^Fdw, Gll^Fmw, Gs^Fms, Gs^Fds, Gs^Fms, Gs^Fms, Gll^Fp, Gll^Fmw, Hh^Fdw, Mm, Mm, Mm^Xm, Ms^Xm, Ms^Xm, Ms, Ms, Ha, Ha, Ha, Spay, Ha, Ha, Ms, Ha, Spay, Ai, Spay, Spay, Aa, Aa, Aa, Xyui, Xyui, Xyui, Xyui
Gll, Gg, Gs^Fds, Xu, Xu, Xu, Xu, Woby, Woby, Woby, Woby, Woby, Woby, Woby, Xu, Xu, Xu, Xu, Gs^Fds, Gll^Fp, Gs^Fms, Gs^Fms, Gll^Fmw, Gs, Gg, Gs^Fms, Gll, Gll^Fmw, Gll^Fp, Gll^Fmw, Gll, Hh, Hh, Mm, Mm^Xm, Mm^Xm, Ms^Xm, Ms^Xm, Ms, Ms, Ha, Ha, Ai, Ha, Ha, Ms, Ms^Xm, Ms, Ha, Spay, Ai, Spay, Ai, Aa, Dyb, Xyui, Xyui, Xyui, Xyui
Gs^Fds, Gs^Fms, Gs^Fds, Gs^Fds, Gll^Fp, Xu, Xu, Xu, Xu, Woby, Woby, Woby, Xu, Xu, Xu, Xu, Gll^Fp, Gs^Fms, Gll^Fp, Gll^Fp, Gs^Fms, Gs^Fms, Gll^Fp, Gll, Gll, Gs, Gs, Gll^Fdw, Gll^Fdw, Gll^Fmw, Gll^Fdw, Hh^Fdw, Mm, Mm, Mm, Mm^Xm, Ms^Xm, Ms^Xm, Ms, Ms, Ms, Ha, Ai, Ai, Ha, Ms, Ayb, Ms, Ha, Ai, Spay, Spay, Ai, Aa, Aa, Dyb, Dyb, Aa, Xyui
Gs^Fms, Gs^Fms, Gs, Gs, Gll^Fp, Gs^Fds, Gs^Fds, Xu, Xu, Xu, Xu, Xu, Xu, Xu, Gs^Fds, Gs^Fms, Gs^Fds, Gll^Fmw, Gll^Fdw, Gll^Fp, Gll^Fmw, Gll^Fdw, Gll^Fmw, Gll^Fmw, Gs, Gll, Gs, Gg, Gs^Fdw, Gll^Fmw, Hh^Fmw, Hh^Fdw, Mm, Mm, Mm^Xm, Mm^Xm, Ms^Xm, Ms^Xm, Ms, Ms, Ms, Ha, Ha, Ai, Ai, Ha, Spay, Ha, Ha, Ai, Spay, Ai, Ha, Aa, Aa, Dyb, Aa, Xyui, Xyui
Gll^Fp, Gs^Fms, Gll^Fp, Gs^Fms, Gs^Fms, Gs^Fds, Gll^Fmw, Gs^Fms, Gll^Fp, Xu, Xu, Xu, Gs^Fp, Gs^Fms, Gs^Fms, Gll^Fp, Gs, Gs, Gs, Gll^Fdw, Gll, Gll, Gll^Fdw, Gll^Fmw, Gs, Gs, Gs, Gs^Fdw, Gll^Fdw, Hh^Fdw, Hh^Fmw, Hh^Fmw, Mm, Mm, Mm^Xm, Ms^Xm, Ms^Xm, Ms^Xm, Ha, Ms, Ha, Spay, Spay, Spay, Spay, Spay, Ha, Ha, Spay, Spay, Ha, Spay, Ha, Ha, Aa, Aa, Ha, Aa, Ha
Gs, Gs^Fds, Gs^Fms, Gs^Fds, Gll^Fp, Gll^Fmw, Gs, Gll, Gll^Fp, Gs^Fms, Gll^Fmw, Gll, Btyb, Gs, Gs, Gs, Gg, Btyb, Gg, Gs, Gs, Gll^Fmw, Gll^Fmw, Gll^Fmw, Gll^Fdw, Gll^Fmw, Gll^Fp, Gll^Fdw, Gll^Fmw, Gs, Hh, Mm, Mm, Mm^Xm, Mm^Xm, Ms^Xm, Ha, Ha, Ha, Ha, Ai, Ha, Ai, Ms, Spay, Spay, Spay, Ha, Spay, Ha, Ha, Ha, Ha, Ha, Ha, Ha, Ha^Fpa, Ha, Ha
Gs^Fds, Gs^Fds, Gs^Fms, Gs^Fms, Gs^Fms, Gs^Fms, Gs, Gs, Gll^Fdw, Gll^Fmw, Gll, Gs, Btym, Gg, Gs, Btyb, Gs, Btym, Gs, Btyb, Gs, Gll^Fdw, Gll, Gll^Fdw, Gll^Fdw, Gll^Fmw, Gll, Gll^Fmw, Gll^Fp, Hh^Fms, Hh, Hh^Fmw, Hh^Fds, Mm, Mm, Mm, Hh, Ha, Ha, Ai, Aa, Ai, Ai, Spay, Ha, Ha, Ha, Spay, Ha, Ha, Ms, Ha, Ha^Fpa, Ha, Ms, Ha^Fpa, Ms, Ha^Fpa, Ha
Gll^Fp, Gs^Fms, Gs^Fms, Gs^Fms, Gs^Fms, Gs^Fds, Gll^Fmw, Gs, Gs, Gll^Fdw, Gs, Gs, Btym, Gg, Gg, Btym, Gg, Btym, Brym, Btym, Gg, Gs, Gs, Gll, Gll, Gll, Gll^Fdw, Gll^Fp, Gll^Fmw, Hh^Fmw, Hh^Fms, Mm, Hh^Fds, Hh^Fmw, Hh, Mm, Hh, Ha, Ha, Ha, Aa, Ai, Ai, Spay, Ai, Ai, Ai, Ai, Ha, Ms, Ms, Ms, Ms, Ms, Ms, Ha^Fpa, Ms, Ms, Ms
Gs^Fms, Gs, Gs, Gs^Fms, Gs, Gll^Fp, Gs, Gll, Gll^Fdw, Gs, Gg, Gg, Brym, Brym, Brym, Btym, Brym, Brym, Brym, Btym, Btyb, Gg, Gs, Gs, Gll, Gs, Gll^Fmw, Gll^Fmw, Gll^Fdw, Hh^Fmw, Hh, Hh^Fds, Mm, Mm, Mm, Hh, Hh, Hh, Hh^Fmw, Ha, Aa, Aa, Ai, Spay, Spay, Ha, Ha, Ha, Ha^Fpa, Ms, Ms, Ms, Ms^Xm, Ms^Xm, Ms, Ms, Ms^Xm, Ms^Xm, Ms
Gs^Fds, Gll^Fp, Gs^Fms, Gll^Fp, Gs, Gs, Gll, Gll, Gll^Fmw, Gll^Fdw, Gg, Btyb, Btyb, Btyb, Btyb, Brym, Btyb, Brym, Brym, Btym, Btym, Btyb, Btyb, Gs, Gs, Gll^Fdw, Gll^Fmw, Gll^Fdw, Gs, Gll^Fdw, Gs, Hh^Fmw, Hh, Mm, Hh, Gg, Hh, Hh, Hh, Ha, Ha, Ha, Ha^Fpa, Ha, Ha^Fpa, Ha, Ms, Ms, Ms, Ms, Ms, Ms, Ms, Ms^Xm, Ms^Xm, Ms^Xm, Ms^Xm, Ms^Xm, Ms^Xm
Gs^Fds, Gs^Fms, Gs^Fms, Gll^Fp, Gs^Fds, Gs, Gll^Fdw, Gll^Fmw, Gll^Fmw, Gll^Fmw, Gs^Fms, Btym, Btym, Btym, Btym, Btyb, Btym, Brym, Brym, Btym, Btym, Btym, Btym, Btyb, Gg, Gll^Fdw, Gs, Gs, Btyb, Gs, Btyb, Hh, Hh, Hh, Gg, Gg, Gg, Gg, Hh, Hh, Hh, Hh^Fmw, Hh^Fmw, Ha^Fda, Ms, Ms, Ms^Xm, Ms, Ms^Xm, Ms^Xm, Ms^Xm, Ms^Xm, Ms^Xm, Ms^Xm, Ms^Xm, Ms^Xm, Ms^Xm, Ms^Xm, Ms^Xm
Gll^Fp, Gs^Fms, Gs^Fms, Gs^Fms, Gll^Fp, Gll^Fp, Gll^Fp, Gll^Fdw, Gll^Fmw, Gll^Fp, Gs, Gs^Fms, Gs^Fms, Gs^Fms, Gll, Btym, Btym, Btyb, Brym, Brym, Brym, Btym, Btym, Btym, Btyb, Gs, Btyb, Btyb, Btym, Btyb, Btym, Btyb, Btyb, Gg, Gg, Gg, Gg, Hh, Mm, Mm, Hh, Hh, Hh^Fdw, Ha^Fda, Ha^Fma, Ms^Xm, Ms, Ms^Xm, Mm^Xm, Ms^Xm, Mm^Xm, Mm^Xm, Mm^Xm, Ms^Xm, Ms^Xm, Md^Xm, Md^Xm, Md^Xm, Md^Xm
Gll^Fp, Gs^Fds, Gs^Fms, Gs, Gll, Gs, Gs^Fms, Gll^Fdw, Gs^Fms, Gs, Gs, Gll^Fp, Gll, Gs^Fms, Gll, Btym, Btym, Btym, Btyb, Brym, Brym, Brym, Brym, Btym, Btym, Btyb, Btym, Btym, Brym, Btym, Brym, Btym, Btym, Btyb, Btyb, Gg, Gg, Hh, Hh, Mm, Gg, Gg, Gg, Ha^Fpa, Ha^Fpa, Ms, Mm, Mm, Mm, Mm^Xm, Mm^Xm, Mm^Xm, Mm, Md^Xm, Md^Xm, Md^Xm, Md^Xm, Md^Xm, Md^Xm
Gll^Fmw, Gll^Fp, Gll^Fmw, Gll^Fdw, Gs^Fms, Gll^Fp, Gg, Gg, Gs, Gs^Fms, Gll, Gll, Btyb, Gll, Btyb, Btyb, Btym, Btym, Btym, Btyb, Btyb, Brym, Gg, Btym, Brym, Btym, Brym, Brym, Brym, Brym, Brym, Brym, Brym, Btym, Btym, Btyb, Btyb, Gg, Hh, Hh, Btyb, Btyb, Gg, Hh^Fdw, Hh^Fdw, Ms, Mm, Mm, Hh, Mm, Mm, Mm, Hh, Mm, Mm, Mm, Mm, Md^Xm, Mm
Gs^Fms, Gll^Fmw, Gs^Fms, Gll^Fp, Gs^Fms, Gs^Fms, Gs, Btyb, Gs, Gs, Btyb, Btyb, Btym, Btyb, Btym, Btym, Brym, Gg, Btym, Btym, Btym, Brym, Btym, Btym, Gg, Brym, Brym, Brym, Brym, Brym, Brym, Brym, Brym, Brym, Brym, Btym, Btym, Btyb, Btyb, Btyb, Btym, Btym, Gg, Gg, Hh, Hh, Mm, Mm, Mm, Hh, Hh, Hh, Hh, Mm, Mm, Mm, Mm^Xm, Mm^Xm, Mm^Xm
Gs^Fms, Gs^Fms, Gs^Fms, Gll^Fmw, Gll^Fmw, Gll^Fp, Gs, Btym, Btyb, Btyb, Btym, Btym, Brym, Btym, Brym, Brym, Brym, Btym, Btyb, Btym, Btyb, Brym, Brym, Gg, Btym, Gg, Brym, Brym, Btyb, Brym, Brym, Brym, Brym, Brym, Brym, Brym, Btym, Btym, Btym, Btym, Btyb, Btym, Gg, Hh, Hh, Hh, Hh, Hh, Hh, Hh, Gg, Gg, Gg, Hh, Hh, Mm, Mm, Mm^Xm, Mm^Xm
Gs^Fds, Gs^Fds, Gs^Fds, Gll^Fp, Gs, Gll^Fdw, Gs, Btym, Btym, Btym, Brym, Brym, Brym, Brym, Brym, Brym, Brym, Btym, Btym, Btyb, Btym, Brym, Brym, Btym, Btym, Btym, Brym, Brym, Btym, Btyb, Brym, Brym, Brym, Brym, Brym, Brym, Brym, Btym, Brym, Btyb, Btym, Btym, Gg, Gg, Gg, Gg, Gg, Hh, Hh, Hh, Gg, Gg, Hh, Hh, Mm, Mm, Mm^Xm, Mm^Xm, Mm^Xm
Gg, Gs^Fms, Gs^Fms, Gll^Fp, Gll^Fdw, Gs, Btyb, Btym, Btym, Brym, Brym, Brym, Brym, Brym, Brym, Brym, Brym, Btym, Btyb, Btym, Btym, Brym, Gg, Brym, Brym, Brym, Btyb, Brym, Btym, Btym, Btyb, Brym, Brym, Brym, Brym^Fynt, Brym, Brym, Btym, Brym, Btym, Btym, Btym, Gg, Gg, Gg, Gg, Hh, Hh, Mm, Hh, Hh, Gg, Hh, Mm, Mm, Mm, Mm^Xm, Mm^Xm, Mm^Xm
Gll^Fp, Gll^Fmw, Gll^Fp, Gll^Fmw, Gll^Fdw, Gg, Btym, Btym, Brym, Brym, Brym, Brym, Brym, Brym^Fynt, Brym, Brym, Brym, Brym, Btym, Btym, Brym, Brym, Btym, Brym, Brym, Brym, Btym, Brym, Brym, Btym, Btym, Brym, Brym, Brym, Brym, Brym, Brym, Brym, Btyb, Btym, Btym, Btym, Gg, Gg, Gg, Gg, Hh, Mm, Hh, Hh, Hh, Hh, Hh, Mm, Hh, Mm, Mm, Mm^Xm, Mm^Xm
Gg, Gll^Fp, Gll, Gs, Gs, Gg, Btym, Btym, Btyb, Brym, Brym, Brym, Brym, Brym, Brym, Brym, Btyb, Brym, Btym, Brym, Btyb, Brym, Btym, Brym, Btyb, Brym, Btym, Brym, Btyb, Brym, Btym, Brym, Btyb, Brym, Brym, Brym, Brym, Brym, Btym, Btym, Btym, Btym, Gg, Gg, Gg, Gg, Gg, Hh, Hh, Hh, Mm, Mm, Hh, Hh, Gg, Hh, Hh, Mm, Mm
Gg, Gll, Gll^Fdw, Gll, Gs, Gs, Gll^Fmw, Btym, Btym, Btyb, Btyb, Brym, Brym, Brym, Brym, Brym, Btym, Brym, Brym, Brym, Btym, Btyb, Btym, Btyb, Btym, Btyb, Btym, Btyb, Btym, Brym, Brym, Brym, Btym, Brym, Brym, Brym, Brym, Brym, Btym, Btym, Gg, Gg, Gg, Gg, Gg, Hh, Hh, Hh, Mm, Hh, Hh, Hh, Gg, Hh, Gg, Gg, Hh, Mm, Mm
Gs^Fds, Gs^Fds, Gll^Fp, Gll^Fdw, Gg, Gll^Fmw, Gll^Fmw, Gll^Fmw, Gs^Fms, Btym, Btym, Gg, Btyb, Brym, Brym, Brym, Brym, Brym, Btyb, Brym, Btym, Btym, Btyb, Btym, Btym, Btym, Btyb, Btym, Btym, Brym, Btyb, Brym, Brym, Brym, Brym, Brym, Btyb, Btyb, Btym, Btym, Gg, Gg, Gg, Gg, Hh, Hh, Hh, Mm, Mm, Hh, Mm, Hh, Hh, Gg, Hh, Hh, Hh, Mm, Mm^Xm
Gs^Fds, Gs^Fms, Gs^Fms, Gll^Fp, Gs, Gs, Gll^Fmw, Gs^Fms, Gll^Fdw, Gll^Fdw, Gs, Btym, Btym, Brym, Brym, Brym, Brym, Brym, Btym, Brym, Brym, Btym, Btym, Btyb, Btyb, Btyb, Btym, Btym, Brym, Brym, Btym, Brym, Brym, Brym, Brym, Btyb, Btym, Btym, Gg, Gg, Gg, Gg, Gg, Hh, Mm, Mm, Hh, Mm, Mm, Mm, Mm, Mm, Mm, Hh, Mm, Mm, Mm, Mm, Mm^Xm
Gs^Fds, Gs^Fms, Gs^Fms, Gll^Fmw, Gll^Fmw, Gll^Fdw, Gs^Fms, Gll^Fmw, Gs, Gs^Fds, Gs^Fms, Btym, Btym, Btyb, Btyb, Brym, Brym, Brym, Brym, Brym, Brym, Brym, Brym, Btym, Btym, Btym, Brym, Brym, Brym, Brym, Brym, Brym, Brym, Brym, Btyb, Btym, Gg, Gg, Gg, Gg, Gg, Gg, Gg, Hh, Hh, Hh, Hh, Mm, Mm, Mm, Mm, Mm, Mm, Mm, Mm, Mm, Mm^Xm, Mm^Xm, Mm^Xm
Hh, Gll^Fp, Gll^Fmw, Gll^Fp, Gll^Fmw, Gll^Fdw, Gll^Fp, Gll^Fp, Gs^Fms, Gs^Fms, Gs, Gs^Fms, Gs, Btym, Btym, Btyb, Btyb, Btyb, Btyb, Brym, Brym, Brym, Brym, Brym, Brym, Brym, Brym, Brym, Btyb, Brym, Btyb, Brym, Btyb, Btyb, Btym, Gg, Gg, Gg, Gg, Gg, Gg, Gg, Gg, Gg, Hh, Hh, Mm, Mm, Mm, Mm, Mm^Xm, Mm^Xm, Mm^Xm, Mm^Xm, Mm^Xm, Mm^Xm, Mm^Xm, Mm^Xm, Mm^Xm
Hh, Hh, Hh, Gg, Gg, Gg, Gg, Gg, Gg, Gs^Fms, Gs^Fms, Gs, Mm, Gs^Fms, Gs^Fds, Btym, Btym, Btym, Btym, Btyb, Btyb, Brym, Btyb, Brym, Btyb, Btyb, Btyb, Btyb, Btym, Btyb, Btym, Btyb, Btym, Btym, Btym, Gg, Gg, Gg, Hh, Gg, Gg, Gg, Gg, Hh, Hh, Mm, Mm^Xm, Mm^Xm, Mm^Xm, Mm^Xm, Mm^Xm, Mm^Xm, Mm^Xm, Mm^Xm, Mm^Xm, Mm^Xm, Mm^Xm, Mm^Xm, Mm^Xm
Mm, Hh, Mm, Hh, Hh, Hh, Hh, Hh, Hh, Hh^Fds, Hh^Fds, Hh^Fds, Hh^Fds, Mm, Gs^Fms, Gs^Fds, Hh, Hh, Hh, Btym, Btym, Btyb, Btym, Btyb, Btym, Btym, Btym, Btym, Hh, Btym, Hh, Btym, Hh, Gg, Gg, Gg, Gg, Hh, Hh, Hh, Hh, Hh, Hh, Gg, Gg, Mm, Mm^Xm, Mm^Xm, Mm^Xm, Mm^Xm, Mm^Xm, Mm^Xm, Mm^Xm, Mm^Xm, Mm^Xm, Mm^Xm, Mm^Xm, Mm^Xm, Mm^Xm
Mm^Xm, Mm, Mm^Xm, Mm, Mm^Xm, Mm, Mm, Mm, Mm, Hh, Mm, Mm, Mm, Hh^Fms, Mm, Hh^Fp, Hh, Mm, Mm, Hh, Hh, Btym, Gs^Fds, Btym, Hh, Gs^Fds, Hh, Hh, Mm, Hh, Mm, Hh, Hh, Gg, Hh, Gg, Hh, Hh, Mm, Mm, Mm, Mm, Mm, Mm, Gg, Gg, Mm^Xm, Mm^Xm, Mm^Xm, Mm^Xm, Gg, Gg, Gg, Gg, Gg, Gg, Gg, Gg, Gg
Xue, Xue, Xue, Mm^Xm, Xue, Mm^Xm, Mm^Xm, Mm, Mm^Xm, Mm^Xm, Mm^Xm, Mm, Mm, Mm, Mm, Mm, Mm, Hh, Mm, Hh, Mm, Hh, Hh, Hh, Hh, Hh, Mm, Hh, Hh, Mm, Mm, Mm, Hh, Gg, Hh, Hh, Hh, Mm, Mm, Mm, Mm^Xm, Mm^Xm, Mm^Xm, Mm^Xm, Mm^Xm, Gg, Gg, Mm^Xm, Gg, Gg, Gg, Gg, Gg, Gg, Gg, Gg, Gg, Gg, Gg
Wog, Wog, Wog, Xue, Wog, Xue, Xue, Xue, Xue, Xue, Xue, Mm^Xm, Mm^Xm, Mm^Xm, Mm^Xm, Mm, Mm^Xm, Mm, Mm^Xm, Mm, Mm^Xm, Hh, Mm, Mm, Mm, Mm, Mm, Mm, Hh, Hh, Hh, Hh, Hh, Hh, Mm, Hh, Mm, Mm, Mm^Xm, Mm^Xm, Mm^Xm, Mm^Xm, Mm^Xm, Mm^Xm, Mm^Xm, Mm^Xm, Gg, Gg, Gg, Gg, Gg, Gg, Gg, Gg, Gg, Gg, Gg, Gg, Gg
Wog, Wog, Wog, Wog, Wog, Wog, Wog, Wog, Wog, Xue, Wog, Xue, Xue, Xue, Xue, Mm^Xm, Xue, Mm^Xm, Xue, Mm^Xm, Mm^Xm, Mm^Xm, Mm^Xm, Mm, Mm^Xm, Mm, Mm^Xm, Mm, Hh, Hh, Mm, Mm, Mm, Mm, Mm, Mm, Mm, Mm^Xm, Mm^Xm, Mm^Xm, Mm^Xm, Mm^Xm, Mm^Xm, Mm^Xm, Gg, Gg, Gg, Gg, Gg, Gg, Gg, Gg, Gg, Gg, Gg, Gg, Gg, Gg, Gg
Wog, Wog, Wog, Wog, Wog, Wog, Wog, Wog, Wog, Wog, Wog, Wog, Xue, Xue, Wog, Xue, Wog, Xue, Wog, Xue, Xue, Mm^Xm, Mm^Xm, Mm^Xm, Mm^Xm, Mm^Xm, Mm, Hh, Uh, Hh, Mm, Mm^Xm, Mm^Xm, Mm, Mm, Mm^Xm, Mm^Xm, Mm^Xm, Mm^Xm, Mm^Xm, Mm^Xm, Mm^Xm, Gg, Gg, Gg, Gg, Gg, Gg, Gg, Gg, Gg, Gg, Gg, Gg, Gg, Gg, Gg, Gg, Gg
Wog, Wog, Wog, Wog, Wog, Wog, Wog, Wog, Wog, Wog, Wog, Wog, Wog, Wog, Wog, Wog, Wog, Wog, Wog, Wog, Wog, Xue, Xue, Mm, Mm, Mm, Uh, Uh, Uh, Mm, Mm^Xm, Mm^Xm, Mm^Xm, Mm^Xm, Mm^Xm, Mm^Xm, Mm^Xm, Mm^Xm, Mm^Xm, Mm^Xm, Gg, Gg, Gg, Gg, Gg, Gg, Gg, Gg, Gg, Gg, Gg, Gg, Gg, Gg, Gg, Gg, Gg, Gg, Gg
Wog, Wog, Wog, Wog, Wog, Wog, Wog, Wog, Wog, Wog, Wog, Wog, Wog, Wog, Wog, Wog, Wog, Wog, Wog, Wog, Wog, Xue, Uh, Mm, Mm, Mm, Uh, Wog, Wog, Mm, Mm, Mm, Mm^Xm, Mm^Xm, Mm^Xm, Mm^Xm, Mm^Xm, Mm^Xm, Mm^Xm, Gg, Gg, Gg, Gg, Gg, Gg, Gg, Gg, Gg, Gg, Gg, Gg, Gg, Gg, Gg, Gg, Gg, Gg, Gg, Gg
Wog, Wog, Wog, Wog, Wog, Wog, Wog, Wog, Wog, Wog, Wog, Wog, Wog, Wog, Qlf, Wog, Wog, Wog, Wog, Wog, Wog, Wog, Wog, Uh, Uh, Uh, Wog, Wog, Wog, Wog, Wog, Wog, Wog, Wog, Wog, Mm^Xm, Xue, Mm^Xm, Mm^Xm, Gg, Gg, Gg, Gg, Gg, Gg, Gg, Gg, Gg, Gg, Gg, Gg, Gg, Gg, Gg, Gg, Gg, Gg, Gg, Gg
Wog, Wog, Qlf, Qlf, Qlf, Qlf, Qlf, Qlf, Wog, Wog, Wog, Wog, Wog, Qlf, Qlf, Qlf, Qlf, Qlf, Qlf, Qlf, Wog, Wog, Wog, Wog, Wog, Wog, Wog, Wog, Wog, Wog, Wog, Wog, Wog, Wog, Wog, Wog, Xue, Mm^Xm, Gg, Gg, Gg, Gg, Gg, Gg, Gg, Gg, Gg, Gg, Gg, Gg, Gg, Gg, Gg, Gg, Gg, Gg, Gg, Gg, Gg
Wog, Wog, Qlf, Qlf, Qlf, Qlf, Qlf, Wog, Wog, Wog, Wog, Wog, Qlf, Qlf, Qlf, Qlf, Qlf, Qlf, Qlf, Qlf, Wog, Wog, Wog, Wog, Wog, Wog, Wog, Wog, Wog, Wog, Wog, Wog, Wog, Wog, Wog, Wog, Xue, Mm^Xm, Gg, Gg, Gg, Gg, Gg, Gg, Gg, Gg, Gg, Gg, Gg, Gg, Gg, Gg, Gg, Gg, Gg, Gg, Gg, Gg, Gg
Qlf, Qlf, Qlf, Qlf, Qlf, Qlf, Qlf, Wog, Wog, Wog, Qlf, Qlf, Qlf, Qlf, Qlf, Qlf, Wog, Qlf, Wog, Wog, Wog, Wog, Wog, Wog, Wog, Wog, Wog, Wog, Wog, Wog, Wog, Wog, Wog, Wog, Wog, Xue, Mm^Xm, Mm^Xm, Gg, Gg, Gg, Gg, Gg, Gg, Gg, Gg, Gg, Gg, Gg, Gg, Gg, Gg, Gg, Gg, Gg, Gg, Gg, Gg, Gg
Qlf, Qlf, Qlf, Qlf, Qlf, Qlf, Qlf, Qlf, Qlf, Qlf, Qlf, Qlf, Qlf, Qlf, Qlf, Qlf, Wog, Wog, Wog, Wog, Wog, Wog, Wog, Wog, Wog, Wog, Wog, Wog, Wog, Wog, Wog, Wog, Wog, Wog, Wog, Xue, Xue, Mm^Xm, Gg, Gg, Gg, Gg, Gg, Gg, Gg, Gg, Gg, Gg, Gg, Gg, Gg, Gg, Gg, Gg, Gg, Gg, Gg, Gg, Gg
Qlf, Qlf, Qlf, Qlf, Qlf, Qlf, Qlf, Qlf, Qlf, Qlf, Qlf, Qlf, Qlf, Qlf, Ql, Qlf, Ql, Wog, Wog, Wog, Ql, Wog, Wog, Wog, Wog, Wog, Wog, Wog, Wog, Wog, Wog, Wog, Wog, Wog, Wog, Wog, Xue, Mm^Xm, Gg, Gg, Gg, Gg, Gg, Gg, Gg, Gg, Gg, Gg, Gg, Gg, Gg, Gg, Gg, Gg, Gg, Gg, Gg, Gg, Gg
Wog, Wog, Wog, Qlf, Qlf, Qlf, Qlf, Qlf, Qlf, Qlf, Qlf, Qlf, Qlf, Ql, Ql, Ql, Ql, Ql, Ql, Ql, Ql, Ql, Wog, Wog, Wog, Wog, Wog, Wog, Wog, Wog, Wog, Wog, Wog, Wog, Wog, Wog, Xue, Mm^Xm, Gg, Gg, Gg, Gg, Gg, Gg, Gg, Gg, Gg, Gg, Gg, Gg, Gg, Gg, Gg, Gg, Gg, Gg, Gg, Gg, Gg
Wog, Wog, Wog, Wog, Wog, Qlf, Wog, Qlf, Qlf, Qlf, Wog, Qlf, Ql, Ql, Ql, Ql, Ql, Ql, Ql, Ql, Ql, Ql, Ql, Wog, Wog, Wog, Wog, Wog, Wog, Wog, Wog, Wog, Wog, Wog, Wog, Wog, Xue, Mm^Xm, Mm^Xm, Gg, Gg, Gg, Gg, Gg, Gg, Gg, Gg, Gg, Gg, Gg, Gg, Gg, Gg, Gg, Gg, Gg, Gg, Gg, Gg
Wog, Wog, Wog, Wog, Wog, Wog, Wog, Wog, Wog, Wog, Wog, Ql, Ql, Ql, Ql, Ql, Ql, Ql, Ql, Ql, Ql, Ql, Ql, Wog, Wog, Wog, Wog, Wog, Wog, Wog, Wog, Wog, Wog, Wog, Wog, Wog, Xue, Mm^Xm, Mm^Xm, Mm^Xm, Mm^Xm, Gg, Gg, Gg, Gg, Gg, Gg, Gg, Gg, Gg, Gg, Gg, Gg, Gg, Gg, Gg, Gg, Gg, Gg
