Gll^Fp, Gll^Fp, Gll^Fp, Gll^Fp, Gs^Fms, Gs^Fds, Gs^Efm, Gs^Efm, Gs^Fds, Gs^Fds, Gs^Fms, Gs^Fms, Gs^Fms, Gs^Fms, Gll^Fp, Gll^Fp, Gll^Fmw, Gll^Fmw, Gll^Fdw, Gll^Fmw, Gll^Fmw, Gll^Fmw, Gll^Fp, Gll^Fp, Gs^Efm, Gs, Gll^Fp, Hh, Hh, Hh, Mm, Mm, Mm^Xm, Mm^Xm, Mm^Xm, Mm^Xm, Ms^Xm, Ms^Xm, Ms^Xm, Ms^Xm, Ms^Xm, Ai, Ms^Xm, Ms^Xm, Ms^Xm, Ms^Xm, Ms, Ha^Fpa, Ha^Fda, Ha, Spay, Ha, Ms, Ms, Ms, Ms, Ms^Xm, Ms^Xm, Ms^Xm
Gs^Fms, Gll^Fp, Gll^Em, Gs^Fms, Gs^Fms, Gs^Fms, Gs^Fds, Gs^Efm, Gs^Fds, Gs^Fms, Gs^Fms, Gs^Fds, Gs^Efm, Gs^Fms, Gs^Fms, Gll^Fp, Gll^Fmw, Gll^Fmw, Gll^Fp, Gll^Fdw, Gll^Em, Gll^Emf, Gll^Fmw, Gll^Fp, Gs^Fds, Gs^Fms, Gll^Fp, Hh, Gs^Fms, Hh^Fmw, Hh, Mm, Hh^Fp, Mm, Mm, Mm^Xm, Mm^Xm, Ms^Xm, Ms^Xm, Ms^Xm, Ms^Xm, Ms^Xm, Ms, Ms^Xm, Ms, Ms, Ha^Fpa, Ha^Fpa, Ha, Spay, Ai, Ha, Ha^Fma, Ms, Ha, Ms, Ms, Ms^Xm, Ms
Gs^Fms, Gll^Fp, Gs^Fms, Gs^Fms, Gs^Fms, Gs^Fms, Gs^Fms, Gs^Fds, Gs^Fms, Gs^Fms, Gs^Fms, Gs^Efm, Gs^Fds, Gs^Fds, Gs^Fms, Gs^Fms, Gll^Fp, Gll^Fp, Gll^Fp, Gll^Fmw, Gll^Fmw, Gll^Fmw, Gll^Fp, Gs^Fms, Gs^Fds, Gll^Fp, Gs^Fms, Gs^Fds, Gll^Fp, Hh^Fmw, Hh^Fms, Hh^Fp, Hh^Fms, Hh^Fp, Mm, Mm^Xm, Mm^Xm, Ms^Xm, Ms^Xm, Ms, Ms, Ms, Ms, Ms, Tyb, Ms, Ms, Ha^Fda, Spay, Spay, Ai, Ha, Ha^Fma, Ms, Ha^Fma, Ms, Xyui, Ms, Xyui
Gs, Gs^Fms, Gs^Fds, Gs^Fds, Gs^Fds, Gll^Fp, Gll^Fp, Gs^Fds, Gs^Fms, Gll^Fp, Gll^Fp, Gll^Fp, Gs^Fds, Gs^Fds, Gs^Fms, Gs^Fms, Gll^Fp, Gll^Fmw, Gll^Fp, Gll^Fmw, Gll^Fmw, Gll^Fp, Gs^Fms, Gs^Fms, Gs^Fds, Gs^Fds, Gs^Fms, Gs^Fms, Gs^Efm, Gll^Fmw, Gll^Fmw, Gs^Fds, Gs^Fms, Hh, Hh^Fmw, Mm, Mm^Xm, Mm^Xm, Ms^Xm, Ms, Ms^Xm, Ms, Ms, Tyb, Ayb, Tyb, Ms, Ha^Fma, Spay, Ai, Spay, Spay, Spay, Spay, Xyui, Xyui, Xyui, Xyui, Xyui
Gll^Fp, Gs^Fms, Gs^Fms, Gs^Fds, Gll^Fp, Gs^Fms, Gll^Fp, Gll^Fp, Gll^Fmw, Gll^Fmw, Gll^Fp, Gs^Fms, Gll^Fp, Gs^Fms, Gll^Fmw, Gll^Em, Gll^Fmw, Gll^Fp, Gll^Fdw, Gll^Fp, Gll^Fmw, Gll^Fmw, Gll^Fp, Gs^Fms, Gll^Fp, Gs^Fds, Gs^Fms, Gll^Fmw, Gll^Fmw, Gll^Fmw, Gll^Fdw, Gs, Gll^Fmw, Hh^Fp, Hh^Fdw, Mm, Mm, Mm^Xm, Mm^Xm, Ms^Xm, Ms^Xm, Ms, Ms, Tyb, Tyb, Tyb, Spay, Ha, Ai, Spay, Ai, Ai, Ai, Ha, Xyui, Xyui, Xyui, Xyui, Xyui
Gll^Fp, Gll^Em, Gll^Fp, Gs^Fds, Gll^Fmw, Gs^Fms, Gs^Fms, Gll^Fp, Gll^Fmw, Gll^Em, Gll^Fp, Gll^Em, Gll^Fp, Gll^Fp, Gll^Fmw, Gll^Fmw, Gll^Fdw, Gll^Em, Gll^Emf, Gll^Fmw, Gll^Fmw, Gll^Emf, Gll^Fdw, Gll^Fmw, Gll^Fmw, Gll^Fp, Gs, Gll^Fp, Gll^Fmw, Gll^Fmw, Gll^Emf, Gs^Efm, Gll^Fdw, Gll^Fmw, Gll^Fmw, Hh^Fdw, Hh, Mm, Mm^Xm, Ms^Xm, Ms, Ms^Xm, Ms^Xm, Ms, Ms, Ms, Aa, Spay, Spay, Spay, Spay, Ai, Spay, Xyui, Xyui, Xyui, Qxyi, Qxyi, Qxyi
Gll^Fp, Gll^Fp, Gll^Fmw, Gll^Fmw, Gll^Fdw, Gll^Fp, Gll^Fmw, Gll^Fmw, Gll^Fmw, Gll^Em, Gll^Fmw, Gll^Fp, Gll^Fp, Gll^Fmw, Rp, Gll^Fmw, Gll^Fdw, Gll^Em, Gll^Em, Gll^Fdw, Gll^Fmw, Gll^Fp, Gs^Fms, Gll^Fp, Gll^Fmw, Gll^Fmw, Gs^Fms, Gs^Efm, Gll^Fmw, Gll^Fmw, Gll^Fmw, Gll^Em, Gs^Efm, Gll, Hh^Fdw, Hh, Mm, Mm^Xm, Ms^Xm, Ms^Xm, Ms^Xm, Ms^Xm, Ms, Ms, Ai, Ai, Spay, Spay, Ha, Spay, Ai, Spay, Xyui, Xyui, Xyui, Xyui, Qxyi, Qxyi, Qxyi
Gs^Fms, Gll^Fp, Gll^Fp, Gll^Fdw, Gll^Em, Gll^Emf, Gll^Em, Gll^Fdw, Gll^Fmw, Gll^Fp, Gll^Fmw, Gll^Fp, Gll^Fp, Gll^Fmw, Gll^Fmw, Gll^Fmw, Gll^Fmw, Gll^Fmw, Gll^Fdw, Gll^Fmw, Gll^Fp, Gs^Fms, Gs^Fds, Gs^Fds, Gll^Fmw, Gll^Fmw, Gll^Fp, Gll^Fp, Gs^Fms, Gll^Fmw, Gll^Emf, Gll^Fmw, Gll^Fdw, Gll^Fdw, Hh^Fmw, Hh^Fmw, Mm^Xm, Mm^Xm, Ms^Xm, Ms^Xm, Ms^Xm, Ms, Ms, Ha^Fda, Ai, Ha, Spay, Ha^Fda, Ha, Spay, Ai, Ha, Xyui, Xyui, Spay, Qxyi, Qxyi, Qxyi, Qxyi
Gs^Fds, Gll^Fp, Gll^Fmw, Gll^Fdw, Gll^Fdw, Gll^Em, Gs^Efm, Gll^Fdw, Gll^Fdw, Gll^Fmw, Gll^Fmw, Gll^Fp, Gs^Fms, Gll^Fp, Gs^Fms, Gll^Fmw, Gll^Fmw, Gll^Fmw, Gll^Fp, Gll^Fmw, Gs^Fds, Gs^Fms, Gs^Fms, Gs^Efm, Gll^Fmw, Gs^Fds, Gs^Fms, Gll^Fp, Gs^Fds, Gs^Efm, Gll^Fp, Gll^Fmw, Hh^Fp, Hh^Fmw, Mm, Mm, Mm^Xm, Mm^Xm, Ms^Xm, Ms^Xm, Ms, Ms, Ha^Fma, Ha, Ai, Ha, Spay, Ai, Ha, Spay, Ai, Ha, Spay, Spay, Spay, Qxyi, Qxyi, Qxyi, Qxyi
Gs^Fds, Gll^Fp, Gll^Fp, Gll^Fmw, Gll^Fmw, Gll^Fdw, Gll^Fmw, Gs^Efm, Gll^Fmw, Gll^Fmw, Wwt^Efm, Gll^Fmw, Gs^Fms, Gg^Ii, Gs^Fds, Gs^Fms, Gll^Fp, Gll^Fp, Rp^Ecf, Gs^Fms, Gs^Efm, Gs^Fms, Gs^Fds, Gll^Fmw, Gll^Fdw, Gll^Fmw, Gs^Fds, Gs^Fms, Gs^Fms, Gs^Fds, Gll^Fp, Gll^Fmw, Hh^Fp, Hh^Fp, Mm, Mm, Mm^Xm, Ms^Xm, Ms^Xm, Ms, Ms, Ha^Fpa, Ha^Fma, Ha, Spay, Spay, Ha, Ai, Ai, Spay, Spay, Spay, Ai, Ai, Xyui, Xyui, Xyui, Qxyi, Qxyi
Gg^Efm, Gs^Fms, Gll^Fp, Gs^Fms, Gs^Fms, Gll^Fp, Gll^Fmw, Gll^Fp, Gll^Fp, Gll^Fp, Gll^Fp, Gll^Fp, Gs^Efm, Gs^Fds, Gs^Fms, Rp, Gs^Fms, Gs^Fms, Gs^Fms, Gll^Fp, Gll^Fp, Gs^Fds, Gs^Fms, Gll^Fmw, Gll^Fdw, Gll^Fmw, Gs^Fms, Gs^Fds, Gs^Fms, Gs^Fms, Gll^Fp, Gll^Fmw, Hh^Fdw, Mm, Mm, Mm^Xm, Ms^Xm, Ms^Xm, Ms, Ms, Ha^Fpa, Ha^Fpa, Ha, Spay, Ha^Fma, Ha, Ms, Ha^Fda, Spay, Ai, Spay, Spay, Aa, Aa, Aa, Xyui, Xyui, Xyui, Xyui
Gll, Gg^Efm, Gs^Fds, Gs^Fms, Gll^Fp, Gll^Fp, Gll^Fp, Gll^Fp, Gs^Fms, Gs^Fms, Gs^Fms, Gs^Fms, Gs^Fms, Gs^Efm, Gs^Fms, Gs^Fms, Gs^Fds, Gs^Fms, Gs^Fds, Gll^Fp, Gs^Fms, Gs^Fms, Gll^Fmw, Gs^Efm, Gg^Efm, Gs^Fms, Gll^Em, Gll^Fmw, Gll^Fp, Gll^Fmw, Gll^Em, Hh, Hh, Mm, Mm^Xm, Mm^Xm, Ms^Xm, Ms^Xm, Ms, Ms, Ha^Fpa, Ha^Fma, Ai, Ha^Fda, Ha^Fma, Ms, Ms^Xm, Ms, Ha, Spay, Ai, Spay, Ai, Aa, Dyb, Xyui, Xyui, Xyui, Xyui
Gs^Fds, Gs^Fms, Gs^Fds, Gs^Fds, Gll^Fp, Gs^Fms, Gs^Efm, Gs^Fds, Gs^Fds, Gs^Fds, Gs^Fds, Gs^Fms, Gll^Fp, Gll^Fp, Gll^Fmw, Gs^Fds, Gll^Fp, Gs^Fms, Gll^Fp, Gll^Fp, Gs^Fms, Gs^Fms, Gll^Fp, Gll^Emf, Gll^Em, Gs, Gs^Gvs, Gll^Fdw, Gll^Fdw, Gll^Fmw, Gll^Fdw, Hh^Fdw, Mm, Mm, Mm, Mm^Xm, Ms^Xm, Ms^Xm, Ms, Ms, Ms, Ha^Fda, Ai, Ai, Ha, Ms, Ayb, Ms, Ha^Fda, Ai, Spay, Spay, Ai, Aa, Aa^Fda, Dyb, Dyb, Aa, Xyui
Gs^Fms, Gs^Fms, Gs^Efm, Gs, Gll^Fp, Gs^Fds, Gs^Fds, Gs^Fms, Gs^Fms, Gs^Fds, Gs^Fms, Gll^Fp, Gll^Fmw, Gll^Fmw, Gs^Fds, Gs^Fms, Gs^Fds, Gll^Fmw, Gll^Fdw, Gll^Fp, Gll^Fmw, Gll^Fdw, Gll^Fmw, Gll^Fmw, Gs, Gll, Gs, Gg^Efm, Gs^Fdw, Gll^Fmw, Hh^Fmw, Hh^Fdw, Mm, Mm, Mm^Xm, Mm^Xm, Ms^Xm, Ms^Xm, Ms, Ms, Ms, Ha, Ha^Fda, Ai, Ai, Ha^Fma, Spay, Ha^Fda, Ha^Fma, Ai, Spay, Ai, Ha, Aa^Fda, Aa^Fda, Dyb, Aa^Fda, Xyui, Xyui
Gll^Fp, Gs^Fms, Gll^Fp, Gs^Fms, Gs^Fms, Gs^Fds, Gll^Fmw, Gs^Fms, Gll^Fp, Gll^Fmw, Gll^Fdw, Gll^Fp, Gll^Em, Gs^Fms, Gs^Fms, Gll^Fp, Gs, Gs, Gs, Gll^Fdw, Gll, Gll, Gll^Fdw, Gll^Fmw, Gs, Gs^Efm, Gs, Gs^Fdw, Gll^Fdw, Hh^Fdw, Hh^Fmw, Hh^Fmw, Mm, Mm, Mm^Xm, Ms^Xm, Ms^Xm, Ms^Xm, Ha^Fpa, Ms, Ha, Spay, Spay, Spay, Spay, Spay, Ha, Ha^Fma, Spay, Spay, Ha, Spay, Ha^Fma, Ha, Aa^Fma, Aa^Fda, Ha^Fma, Aa^Fda, Ha
Gs, Gs^Fds, Gs^Fms, Gs^Fds, Gll^Fp, Gll^Fmw, Gs^Efm, Gll^Em, Gll^Fp, Gs^Fms, Gll^Fmw, Gll^Em, Btyb, Gs, Gs, Gs, Gg^Efm, Btyb, Gg^Efm, Gs, Gs, Gll^Fmw, Gll^Fmw, Gll^Fmw, Gll^Fdw, Gll^Fmw, Gll^Fp, Gll^Fdw, Gll^Fmw, Gs, Hh, Mm, Mm, Mm^Xm, Mm^Xm, Ms^Xm, Ha^Fpa, Ha^Fpa, Ha^Fma, Ha^Fda, Ai, Ha^Fda, Ai, Ayb, Spay, Spay, Spay, Ha^Fma, Spay, Ha^Fda, Ha^Fma, Ha^Fma, Ha^Fpa, Ha^Fma, Ha^Fma, Ha^Fma, Ha^Fpa, Ha^Fma, Ha
Gs^Fds, Gs^Fds, Gs^Fms, Gs^Fms, Gs^Fms, Gs^Fms, Gs^Efm, Gs, Gll^Fdw, Gll^Fmw, Gll^Em, Gs, Btym, Gg^Efm, Gs, Btyb, Gs, Btym, Gs, Btyb, Gs, Gll^Fdw, Gll^Em, Gll^Fdw, Gll^Fdw, Gll^Fmw, Gll^Emf, Gll^Fmw, Gll^Fp, Hh^Fms, Hh, Hh^Fmw, Hh^Fds, Mm, Mm, Mm, Hh^Fmw, Ha^Fpa, Ha^Fma, Ai, Aa, Ai, Ai, Spay, Ha^Fda, Ha, Ha, Spay, Ha, Ha^Fda, Ms, Ha^Fma, Ha^Fpa, Ha^Fpa, Ms, Ha^Fpa, Ms, Ha^Fpa, Ha^Fma
Gll^Fp, Gs^Fms, Gs^Fms, Gs^Fms, Gs^Fms, Gs^Fds, Gll^Fmw, Gs, Gs, Gll^Fdw, Gs^Es, Gs, Btym, Gg^Es, Gg, Btym, Gg, Btym, Brym, Btym, Gg, Gs^Es, Gs^Es, Gll^Em, Gll^Em, Gll, Gll^Fdw, Gll^Fp, Gll^Fmw, Hh^Fmw, Hh^Fms, Mm, Hh^Fds, Hh^Fmw, Hh, Mm, Hh, Ha^Fda, Ha^Fma, Ha^Fda, Aa^Fda, Ai, Ai, Spay, Ai, Ai, Ai, Ai, Ha^Fda, Ms, Ms, Ms, Ms, Ms, Ms, Ha^Fpa, Ms, Ms, Ms
Gs^Fms, Gs, Gs^Efm, Gs^Fms, Gs^Efm, Gll^Fp, Gs, Gll^Em, Gll^Fdw, Gs^Em, Gg^Es, Gg, Brym, Brym, Brym, Btym, Brym, Brym, Brym, Btym, Btyb, Gg^Efm, Gs, Gs, Gll^Es, Gs, Gll^Fmw, Gll^Fmw, Gll^Fdw, Hh^Fmw, Hh, Hh^Fds, Mm, Mm, Mm, Hh^Fmw, Hh, Hh^Fdw, Hh^Fmw, Ha^Fma, Aa^Fda, Aa, Ai, Spay, Spay, Ha, Ha, Ha^Fda, Ha^Fma, Ms, Ms, Ms, Ms^Xm, Ms^Xm, Ms, Ms, Ms^Xm, Ms^Xm, Ms
Gs^Fds, Gll^Fp, Gs^Fms, Gll^Fp, Gs^Efm, Gs^Es, Gll^Em, Gll^Emf, Gll^Fmw, Gll^Fdw, Gg^Efm, Btyb, Btyb, Btyb, Btyb, Brym, Btyb, Brym, Brym, Btym, Btym, Btyb, Btyb, Gs^Es, Gs, Gll^Fdw, Gll^Fmw, Gll^Fdw, Gs^Es, Gll^Fdw, Gs^Es, Hh^Fmw, Hh^Es, Mm, Hh^Fmw, Gs^Em, Hh^Fp, Hh, Hh^Es, Ha^Fma, Ha, Ha, Ha^Fpa, Ha^Fda, Ha^Fpa, Ha^Fma, Ms, Ms, Ms, Ms, Ms, Ms, Ms, Ms^Xm, Ms^Xm, Ms^Xm, Ms^Xm, Ms^Xm, Ms^Xm
Gs^Fds, Gs^Fms, Gs^Fms, Gll^Fp, Gs^Fds, Gs, Gll^Fdw, Gll^Fmw, Gll^Fmw, Gll^Fmw, Gs^Fms, Btym, Btym, Btym, Btym, Btyb, Btym, Brym, Brym, Btym, Btym, Btym, Btym, Btyb, Gg^Efm, Gll^Fdw, Gs, Gs^Es, Btyb, Gs, Btyb, Hh, Hh, Hh^Fdw, Gs^Es, Gll^Fp, Gll^Fp, Gll^Emf, Hh^Fmw, Hh^Es, Hh^Es, Hh^Fmw, Hh^Fmw, Ha^Fda, Ms, Ms, Ms^Xm, Ms, Ms^Xm, Ms^Xm, Ms^Xm, Ms^Xm, Ms^Xm, Ms^Xm, Ms^Xm, Ms^Xm, Ms^Xm, Ms^Xm, Ms^Xm
Gll^Fp, Gs^Fms, Gs^Fms, Gs^Fms, Gll^Fp, Gll^Fp, Gll^Fp, Gll^Fdw, Gll^Fmw, Gll^Fp, Gs^Efm, Gs^Fms, Gs^Fms, Gs^Fms, Gll^Em, Btym, Btym, Btyb, Brym, Brym, Brym, Btym, Btym, Btym, Btyb, Gs^Es, Btyb, Btyb, Btym, Btyb, Btym, Btyb, Btyb, Gg^Efm, Gs^Es, Gll^Fdw, Gll^Fmw, Hh^Fdw, Mm, Mm, Hh^Es, Hh^Fmw, Hh^Fdw, Ha^Fda, Ha^Fma, Ms^Xm, Ms, Ms^Xm, Mm^Xm, Ms^Xm, Mm^Xm, Mm^Xm, Mm^Xm, Ms^Xm, Ms^Xm, Md^Xm, Md^Xm, Md^Xm, Md^Xm
Gll^Fp, Gs^Fds, Gs^Fms, Gs, Gll^Em, Gs^Efm, Gs^Fms, Gll^Fdw, Gs^Fms, Gs, Gs^Efm, Gll^Fp, Gll^Em, Gs^Fms, Gll^Em, Btym, Btym, Btym, Btyb, Brym, Brym, Brym, Brym, Btym, Btym, Btyb, Btym, Btym, Brym^Ebn, Btym, Brym, Btym, Btym, Btyb, Btyb, Gs^Efm, Gg^Es, Hh^Fdw, Hh, Mm, Gg^Es, Gs, Gs, Ha^Fpa, Ha^Fpa, Ms, Mm, Mm, Mm, Mm^Xm, Mm^Xm, Mm^Xm, Mm, Md^Xm, Md^Xm, Md^Xm, Md^Xm, Md^Xm, Md^Xm
Gll^Fmw, Gll^Fp, Gll^Fmw, Gll^Fdw, Gs^Fms, Gll^Fp, Gg^Efm, Gg^Efm, Gs^Efm, Gs^Fms, Gll, Gll^Em, Btyb, Gll^Em, Btyb, Btyb, Btym, Btym, Btym, Btyb, Btyb, Brym, Gg, Btym, Brym, Btym, Brym, Brym, Brym, Brym, Brym, Brym, Brym, Btym, Btym, Btyb, Btyb, Gg^Efm, Hh, Hh, Btyb, Btyb, Gg^Efm, Hh^Fdw, Hh^Fdw, Ms, Mm, Mm, Hh, Mm, Mm, Mm, Hh, Mm, Mm, Mm, Mm, Md^Xm, Mm
Gs^Fms, Gll^Fmw, Gs^Fms, Gll^Fp, Gs^Fms, Gs^Fms, Gs, Btyb, Gs, Gs, Btyb, Btyb, Btym, Btyb, Btym, Btym, Brym, Gg, Btym, Btym, Btym, Brym, Btym, Btym, Gg, Brym, Brym, Brym, Brym, Brym, Brym, Brym, Brym, Brym, Brym, Btym, Btym, Btyb, Btyb, Btyb, Btym, Btym, Gg, Gg^Efm, Hh, Hh, Mm, Mm, Mm, Hh^Es, Hh^Fdw, Hh^Fdw, Hh^Es, Mm, Mm, Mm, Mm^Xm, Mm^Xm, Mm^Xm
Gs^Fms, Gs^Fms, Gs^Fms, Gll^Fmw, Gll^Fmw, Gll^Fp, Gs, Btym, Btyb, Btyb, Btym, Btym, Brym^Ebn, Btym, Brym, Brym, Brym, Btym, Btyb, Btym, Btyb, Brym, Brym, Gg, Btym, Gg, Brym, Brym, Btyb, Brym, Brym, Brym, Brym, Brym, Brym, Brym, Btym, Btym, Btym, Btym, Btyb, Btym, Gs, Hh^Fdw, Hh^Fdw, Hh, Hh^Fdw, Hh^Es, Hh^Fdw, Hh^Es, Gll^Fmw, Gll^Fmw, Gs^Efm, Hh, Hh^Fdw, Mm, Mm, Mm^Xm, Mm^Xm
Gs^Fds, Gs^Fds, Gs^Fds, Gll^Fp, Gs^Efm, Gll^Fdw, Gs, Btym, Btym, Btym, Brym, Brym, Brym, Brym, Brym, Brym, Brym, Btym, Btym, Btyb, Btym, Brym, Brym, Btym, Btym, Btym, Brym, Brym, Btym, Btyb, Brym, Brym, Brym, Brym, Brym, Brym, Brym^Ebn, Btym, Brym, Btyb, Btym, Btym, Gg^Es, Gs, Gs^Efm, Gs^Efm, Gll^Fdw, Hh^Es, Hh^Es, Hh^Fmw, Gll^Fp, Gll^Fdw, Hh, Hh^Fdw, Mm, Mm, Mm^Xm, Mm^Xm, Mm^Xm
Gg, Gs^Fms, Gs^Fms, Gll^Fp, Gll^Fdw, Gs, Btyb, Btym, Btym, Brym, Brym, Brym, Brym, Brym, Brym, Brym, Brym, Btym, Btyb, Btym, Btym, Brym, Gg, Brym, Brym, Brym, Btyb, Brym, Btym, Btym, Btyb, Brym, Brym, Brym, Brym^Fynt, Brym, Brym, Btym, Brym, Btym, Btym, Btym, Gg^Es, Gs, Gs^Efm, Gll^Fmw, Hh^Fdw, Hh^Es, Mm, Hh, Hh, Gs^Efm, Hh^Fdw, Mm, Mm, Mm, Mm^Xm, Mm^Xm, Mm^Xm
Gll^Fp, Gll^Fmw, Gll^Fp, Gll^Fmw, Gll^Fdw, Gg^Efm, Btym, Btym, Brym^Ebn, Brym, Brym, Brym, Brym, Brym^Fynt, Brym, Brym, Brym, Brym^Ebn, Btym, Btym, Brym, Brym, Btym, Brym, Brym, Brym, Btym, Brym, Brym, Btym, Btym, Brym, Brym, Brym, Brym, Brym, Brym, Brym, Btyb, Btym, Btym, Btym, Gs, Gll^Fmw, Gll^Fmw, Gll^Fp, Hh^Fdw, Mm, Hh^Es, Hh^Fdw, Hh, Hh^Es, Hh^Es, Mm, Hh^Fdw, Mm, Mm, Mm^Xm, Mm^Xm
Gg, Gll^Fp, Gll^Em, Gs, Gs^Es, Gg^Efm, Btym, Btym, Btyb, Brym, Brym, Brym, Brym, Brym, Brym, Brym, Btyb, Brym, Btym, Brym, Btyb, Brym, Btym, Brym, Btyb, Brym, Btym, Brym, Btyb, Brym, Btym, Brym, Btyb, Brym, Brym, Brym, Brym, Brym, Btym, Btym, Btym, Btym, Gll^Fp, Gll^Fp, Gll^Em, Gll^Em, Gll^Emf, Hh, Hh^Es, Hh^Fdw, Mm, Mm, Hh^Es, Hh^Es, Gs^Efm, Hh^Fdw, Hh, Mm, Mm
Gg, Gll^Emf, Gll^Fdw, Gll^Em, Gs, Gs^Es, Gll^Fmw, Btym, Btym, Btyb, Btyb, Brym, Brym, Brym, Brym, Brym, Btym, Brym, Brym, Brym, Btym, Btyb, Btym, Btyb, Btym, Btyb, Btym, Btyb, Btym, Brym, Brym, Brym, Btym, Brym, Brym, Brym, Brym, Brym^Ebn, Btym, Btym, Gg, Gll^Fp, Gs^Fms, Gll^Fmw, Gll^Fmw, Hh^Fmw, Hh^Fmw, Hh^Fdw, Mm, Hh^Es, Hh^Es, Hh^Es, Gll^Em, Hh^Fdw, Gll^Fmw, Gll^Emf, Hh^Fdw, Mm, Mm
Gs^Fds, Gs^Fds, Gll^Fp, Gll^Fdw, Gg^Efm, Gll^Fmw, Gll^Fmw, Gll^Fmw, Gs^Fms, Btym, Btym, Gg, Btyb, Brym, Brym, Brym, Brym, Brym, Btyb, Brym, Btym, Btym, Btyb, Btym, Btym, Btym, Btyb, Btym, Btym, Brym, Btyb, Brym, Brym, Brym, Brym, Brym, Btyb, Btyb, Btym, Btym, Gs^Fms, Gll^Fp, Gs^Fms, Gg^Fp, Hh^Fmw, Hh, Hh^Fmw, Mm, Mm, Hh^Fdw, Mm, Hh^Fdw, Hh^Fp, Gll^Fp, Hh^Fmw, Hh^Fdw, Hh, Mm, Mm^Xm
Gs^Fds, Gs^Fms, Gs^Fms, Gll^Fp, Gs, Gs, Gll^Fmw, Gs^Fms, Gll^Fdw, Gll^Fdw, Gs^Es, Btym, Btym, Brym^Ebn, Brym, Brym, Brym, Brym, Btym, Brym, Brym, Btym, Btym, Btyb, Btyb, Btyb, Btym, Btym, Brym, Brym, Btym, Brym, Brym, Brym, Brym, Btyb, Btym, Btym, Gs^Fds, Gs^Fds, Gs^Fds, Gll^Fp, Gll^Fp, Hh^Fp, Mm, Mm, Hh^Fdw, Mm, Mm, Mm, Mm, Mm, Mm, Hh^Fp, Mm, Mm, Mm, Mm, Mm^Xm
Gs^Fds, Gs^Fms, Gs^Fms, Gll^Fmw, Gll^Fmw, Gll^Fdw, Gs^Fms, Gll^Fmw, Gs^Efm, Gs^Fds, Gs^Fms, Btym, Btym, Btyb, Btyb, Brym, Brym, Brym, Brym, Brym, Brym, Brym, Brym, Btym, Btym, Btym, Brym, Brym, Brym, Brym, Brym, Brym, Brym, Brym, Btyb, Btym, Gll^Fdw, Gll^Fmw, Gs^Fms, Gs^Fds, Gs^Fms, Gs^Fms, Gll^Fmw, Hh^Fdw, Hh, Hh^Fdw, Hh^Es, Mm, Mm, Mm, Mm, Mm, Mm, Mm, Mm, Mm, Mm^Xm, Mm^Xm, Mm^Xm
Hh^Fds, Gll^Fp, Gll^Fmw, Gll^Fp, Gll^Fmw, Gll^Fdw, Gll^Fp, Gll^Fp, Gs^Fms, Gs^Fms, Gs^Efm, Gs^Fms, Gs, Btym, Btym, Btyb, Btyb, Btyb, Btyb, Brym, Brym, Brym, Brym, Brym, Brym, Brym, Brym, Brym, Btyb, Brym, Btyb, Brym, Btyb, Btyb, Btym, Gs^Es, Gll^Em, Gll^Fmw, Gll^Fmw, Gll^Fmw, Gll^Fmw, Gll^Fp, Gll^Fdw, Gg^Efm, Hh, Hh^Es, Mm, Mm, Mm, Mm, Mm^Xm, Mm^Xm, Mm^Xm, Mm^Xm, Mm^Xm, Mm^Xm, Mm^Xm, Mm^Xm, Mm^Xm
Hh^Fms, Hh^Fms, Hh^Es, Gll^Emf, Gll^Em, Gs, Gg^Efm, Gg^Efm, Gg^Efm, Gs^Fms, Gs^Fms, Gs^Efm, Mm, Gs^Fms, Gs^Fds, Btym, Btym, Btym, Btym, Btyb, Btyb, Brym, Btyb, Brym, Btyb, Btyb, Btyb, Btyb, Btym, Btyb, Btym, Btyb, Btym, Btym, Btym, Gs, Gll^Fdw, Gll^Emf, Hh^Fdw, Gll^Em, Gg^Fdw, Gll^Fmw, Gg^Efm, Hh, Hh^Es, Mm, Mm^Xm, Mm^Xm, Mm^Xm, Mm^Xm, Mm^Xm, Mm^Xm, Mm^Xm, Mm^Xm, Mm^Xm, Mm^Xm, Mm^Xm, Mm^Xm, Mm^Xm
Mm, Hh^Fp, Mm, Hh, Hh, Hh, Hh, Hh, Hh^Es, Hh^Fds, Hh^Fds, Hh^Fds, Hh^Fds, Mm, Gs^Fms, Gs^Fds, Hh, Hh, Hh, Btym, Btym, Btyb, Btym, Btyb, Btym, Btym, Btym, Btym, Hh^Fdw, Btym, Hh^Fdw, Btym, Hh^Fp, Gs^Fds, Gs^Fds, Gll^Fmw, Gs^Efm, Hh, Hh^Es, Hh^Es, Hh^Es, Hh^Fdw, Hh, Gg^Es, Gg, Mm, Mm^Xm, Mm^Xm, Mm^Xm, Mm^Xm, Mm^Xm, Mm^Xm, Mm^Xm, Mm^Xm, Mm^Xm, Mm^Xm, Mm^Xm, Mm^Xm, Mm^Xm
Mm^Xm, Mm, Mm^Xm, Mm, Mm^Xm, Mm, Mm, Mm, Mm, Hh^Es, Mm, Mm, Mm, Hh^Fms, Mm, Hh^Fp, Hh, Mm, Mm, Hh^Fmw, Hh^Fmw, Btym, Gs^Fds, Btym, Hh^Fmw, Gs^Fds, Hh, Hh^Fmw, Mm, Hh, Mm, Hh^Fp, Hh^Fms, Gs^Fms, Hh^Fmw, Gs^Fms, Hh^Fdw, Hh^Es, Mm, Mm, Mm, Mm, Mm, Mm, Gg, Gg, Mm^Xm, Mm^Xm, Mm^Xm, Mm^Xm, Mm, Mm, Mm, Mm, Mm, Mm, Mm, Mm, Mm
Xue, Xue, Xue, Mm^Xm, Xue, Mm^Xm, Mm^Xm, Mm, Mm^Xm, Mm^Xm, Mm^Xm, Mm, Mm, Mm, Mm, Mm, Mm, Hh, Mm, Hh^Fmw, Mm, Hh^Fms, Hh^Fmw, Hh, Hh^Fdw, Hh^Fmw, Mm, Hh^Fdw, Hh, Mm, Mm, Mm, Hh^Fdw, Gg^Efm, Hh^Es, Hh, Hh^Em, Mm, Mm, Mm, Mm^Xm, Mm^Xm, Mm^Xm, Mm^Xm, Mm^Xm, Gg^Efm, Gg^Efm, Mm^Xm, Mm, Mm, Mm, Mm, Mm, Mm, Hh^Fp, Mm, Hh^Fp, Mm, Hh
Ql, Ql^Ecf, Ql, Xue, Ql, Xue, Xue, Xue, Xue, Xue, Xue, Mm^Xm, Mm^Xm, Mm^Xm, Mm^Xm, Mm, Mm^Xm, Mm, Mm^Xm, Mm, Mm^Xm, Hh, Mm, Mm, Mm, Mm, Mm, Mm, Hh^Es, Hh^Es, Hh^Fdw, Hh, Hh^Em, Hh^Em, Mm, Hh^Emf, Mm, Mm, Mm^Xm, Mm^Xm, Mm^Xm, Mm^Xm, Mm^Xm, Mm^Xm, Mm^Xm, Hh, Hh^Es, Hh^Es, Hh^Fdw, Hh, Btyb, Hh^Fdw, Hh, Hh^Fdw, Gll^Em, Hh^Fp, Hh^Fmw, Hh^Fp, Hh^Fds
Ql, Qlf, Woby, Ql, Woby, Ql, Ql^Ecf, Qlf, Qlf, Xue, Ql^Ecf, Xue, Xue, Xue, Xue, Mm^Xm, Xue, Mm^Xm, Xue, Mm^Xm, Mm^Xm, Mm^Xm, Mdd^Xm, Mm, Mdd^Xm, Mm, Mm^Xm, Mm, Hh^Es, Hh^Fdw, Mm, Mm, Mm, Mm, Mm, Mm, Mm, Mm^Xm, Mm^Xm, Mm^Xm, Mm^Xm, Mm^Xm, Mm^Xm, Mm^Xm, Mm, Mm, Hh, Btyb, Gs, Hh, Btym, Hh, Gs^Efm, Btyb, Gs^Efm, Gll^Fdw, Gll^Fmw, Hh^Fms, Hh^Fds
Qlf, Qlf, Woby, Woby, Qlf, Qlf, Qlf, Qlf, Qlf, Ql, Qlf, Ql^Ecf, Xue, Xue, Wog, Xue, Qlf, Xue, Ql^Ecf, Xue, Xue, Mm^Xm, Mdd^Xm, Mdd^Xm, Mdd^Xm, Mdd^Xm, Mdd, Hh^Fdw, Hhd^Edp, Hh^Es, Mdd, Mm^Xm, Mdd^Xm, Mm, Mm, Mm^Xm, Mm^Xm, Mm^Xm, Mm^Xm, Mm^Xm, Mm^Xm, Mm^Xm, Mm, Mm, Hh^Fmw, Hh^Fdw, Gs^Efm, Btym, Gg^Efm, Gs, Btym, Gs^Efm, Gg, Btym, Gs, Gll^Emf, Gll^Fdw, Gll^Fmw, Hh^Fms
Woby, Woby, Woby, Woby, Qlf, Qlf, Woby, Qlf, Woby, Qlf, Qlf, Ql, Ql, Wog, Wog^Edb, Qlf, Qlf, Ql, Qlf, Ql, Qlf, Xue, Xue, Mdd, Mdd, Mdd, Hhd^Edp, Hhd, Hhd^Edp, Mdd, Mdd^Xm, Mdd^Xm, Mdd^Xm, Mdd^Xm, Mdd^Xm, Mdd^Xm, Mdd^Xm, Mm^Xm, Mm^Xm, Mm^Xm, Mm, Mm, Hh^Fmw, Hh, Hh^Fdw, Gll^Fdw, Gs^Efm, Btym, Gg, Gg, Gg, Gg, Gg, Btym, Gg^Efm, Gs^Em, Gll^Em, Gll^Fdw, Gll^Fmw
Ql, Woby, Qlf, Woby, Woby, Qlf, Wog, Woby, Wog, Woby, Qlf, Qlf, Qlf, Qlf, Wog^Edb, Wog^Edb, Wog^Edb, Wog, Wog^Edb, Qlf, Wog, Xue, Hhd, Mdd, Mdd, Mdd, Hhd^Edp, Ww^Ewf, Ww^Ewf, Mdd, Mdd, Mdd, Mdd^Xm, Mdd^Xm, Mdd^Xm, Mdd^Xm, Mdd^Xm, Mm^Xm, Mm^Xm, Mm, Mm, Mm, Hh^Fdw, Hh^Es, Btyb, Gs^Efm, Cmy, Gs^Es, Gg^Es, Cmy, Gg^Es, Cmy, Gg^Es, Gg^Es, Cmy, Gs, Btyb, Gll^Em, Gll^Fdw
Ql, Qlf, Qlf, Woby, Woby, Woby, Wog, Wog, Wog, Wog^Edb, Wog^Edb, Wog^Edb, Wog, Wog^Edb, Qlf, Wog^Edb, Wog^Edb, Wog, Wog, Wog^Edb, Wog, Wog, Wog^Edb, Hhd^Edp, Hhd^Edp, Hhd, Wog, Ww^Ewf, Wwg, Wwg, Wwg^Ewl, Wwg^Ewl, Wwrg, Wwrg, Wwg^Ewl, Mdd^Xm, Xue, Mm^Xm, Mm^Xm, Mm, Hh^Fmw, Hh^Fdw, Gll^Fdw, Gll^Em, Btym, Gs, Gg^Es, Cmy, Cmy, Cmy, Kmy, Cmy, Cmy, Cmy, Gg^Es, Gg, Btym, Gs^Efm, Gs^Efm
Ql, Qlf, Ql, Qlf, Qlf, Qlf, Qlf, Qlf, Woby, Wog, Woby, Wog, Woby, Wog^Edb, Woby, Qlf, Qlf, Qlf, Qlf, Qlf, Woby, Wog, Wog, Wog^Edb, Wog^Edb, Wog^Edb, Wog, Wog, Wwg, Wwg, Wwrg, Wwg^Ewl, Wwg, Wwg, Wwrg, Wwrg, Xue, Mm^Xm, Mm, Mm, Hh^Fp, Hh^Fp, Gll^Fmw, Gll^Em, Btym, Gg^Efm, Gg^Es, Kmy, Brym, Brym, Brym, Brym, Brym, Kmy, Gg^Es, Gg^Efm, Btym, Gs, Gll
Hhd, Ql, Hhd^Edp, Qlf, Qlf, Qlf, Ql, Woby, Woby, Woby, Ql, Ql, Qlf, Woby, Woby, Qlf, Qlf, Qlf, Qlf, Qlf, Woby, Wog, Woby, Wog, Wog, Wog^Edb, Wog, Wog, Wwrg, Wwg^Ewl, Wwg^Ewl, Wwg, Wog, Wog, Wwg, Wwrg, Xue, Mm^Xm, Mm, Mm, Hh, Gll^Fp, Gll^Fdw, Gll^Fdw, Gs, Btyb, Gg, Kmy, Cmy, Brym, Kmy, Brym, Cmy, Kmy, Gg, Btyb, Gs^Efm, Gs^Efm, Gll^Fdw
Hhd, Hhd^Edp, Hhd^Edp, Ql, Ql^Ecf, Ql, Qlf, Ql, Woby, Woby, Ql, Qlf, Qlf, Woby, Qlf, Qlf, Woby, Qlf, Woby, Woby, Woby, Woby, Woby, Qlf, Qlf, Wog, Wog, Wog, Wwg, Wwrg, Wwg^Ewl, Wwrg, Wwg, Wog, Wog, Xue, Mm^Xm, Mm^Xm, Mm, Mm, Hh^Fmw, Hh^Fmw, Gll^Fmw, Gs^Em, Gs^Efm, Btym, Gg^Efm, Gg, Gg^Es, Cmy, Gg^Es, Cmy, Gg^Es, Gg^Es, Gg^Efm, Btym, Gs, Gll^Em, Gll^Fdw
Mdd, Mdd^Efs, Mdd, Hhd, Ql, Qlf, Qlf, Qlf, Qlf, Qlf, Ql, Qlf, Qlf, Qlf, Qlf, Qlf, Woby, Woby, Woby, Woby, Qlf, Woby, Qlf, Qlf, Wog^Edb, Wog, Wwg, Wwrg, Wwg, Wwrg, Wwg, Wwrg, Wwrg, Wwg, Wog, Xue, Xue, Mm^Xm, Mm, Hh^Fdw, Hh^Fdw, Hh^Fmw, Hh^Fdw, Gll^Fdw, Gs^Em, Btym, Gs, Btyb, Gg, Gg^Es, Btyb, Gg, Gg^Es, Btyb, Gs, Btym, Gs^Em, Gll^Fdw, Gll^Fmw
Mdd^Xm, Mdd^Xm, Mv, Mdd^Efs, Qlf, Qlf, Hhd, Hhd, Hhd^Edp, Qlf, Ql, Ql, Qlf, Qlf, Ql, Qlf, Ql, Qlf, Qlf, Qlf, Qlf, Qlf, Qlf, Wog, Wog^Edb, Wog^Edb, Wog, Wwg, Wwg, Wwg, Wwrg, Wwg^Ewl, Wwg, Wwg, Wog, Qlf, Xue, Mm^Xm, Mm, Mm, Mm, Hh, Hh, Gll^Emf, Gll^Fdw, Gll^Em, Gs^Efm, Btym, Gg, Gg, Btym, Gg, Gs, Btym, Gs, Gs^Efm, Gll^Emf, Gll^Fmw, Gs^Fms
Mdd^Xm, Mdd^Xm, Mv, Qlf, Mv, Mdd^Efs, Mdd, Hhd^Edp, Hhd^Edp, Ql, Ql, Qlf, Qlf, Ql, Ql, Ql, Ql, Qlf, Ql, Qlf, Ql, Qlf, Qlf, Wog, Wog, Wog, Wog^Edb, Wog, Wog, Wog, Wwg, Wwrg, Wwg, Wog, Qlf, Qlf, Xue, Mm^Xm, Mm, Mm, Mm, Mm, Hh^Fp, Hh^Fmw, Hh^Fp, Gll^Fdw, Gll^Em, Btym, Gs, Gg^Efm, Btym, Gg^Efm, Gs, Btym, Gs^Em, Gll^Fdw, Gll^Fmw, Gll^Fp, Gs^Fds
Mdd^Xm, Mdd^Xm, Mdd^Xm, Mv, Mdd^Xm, Mdd^Xm, Mdd, Hhd, Mdd, Hhd, Hhd^Edp, Ql, Ql, Ql, Ql^Ecf, Ql^Ecf, Ql, Ql, Ql^Ecf, Ql, Ql, Ql, Qlf, Qlf, Wog, Wog, Wog, Wog^Edb, Wog^Edb, Wog, Wog, Wwg, Wog, Wog, Qlf, Qlf, Xue, Mm^Xm, Mm^Xm, Mm, Mm, Mm, Hh^Fms, Hh^Fds, Hh^Fms, Gll^Fmw, Gll^Fdw, Gs, Gs^Efm, Gs, Gs^Efm, Gs, Gll^Fdw, Gs^Em, Gll^Fdw, Gll^Fmw, Gll^Fp, Gs^Fms, Gs^Fds
Mdd^Xm, Mdd^Xm, Mdd^Xm, Mdd^Xm, Mdd^Xm, Mdd^Xm, Mdd, Mdd^Efs, Mdd, Hhd, Hhd, Ql, Ql, Ql, Ql, Ql^Ecf, Ql, Ql, Ql^Ecf, Ql^Ecf, Ql, Ql, Ql, Qlf, Qlf, Wog, Wog, Wog^Edb, Wog, Wog, Wog, Wog, Qlf, Qlf, Ql, Ql^Ecf, Xue, Mm^Xm, Mm, Mm^Xm, Mm^Xm, Mm, Mm, Mm, Hh, Hh^Fmw, Gg, Gll^Fdw, Gs, Gll, Gll, Gll^Fdw, Gll^Fmw, Gll^Fmw, Gll^Fmw, Gll^Fp, Gs^Fds, Gs^Fds, Gs^Fds
