Gd, Gs, Gs^Fmw, Gs, Re, Gd^Fdw, Re, Gd, Gs^Fmw, Gs, Gd^Fdw, Gd, Gd, Gd, Ww, Ww, Wo, Wo, Wo, Wo, Wo, Wo, Wo, Wo, Wo, Wo, Wo, Wo, Wo, Wo, Wo, Wo, Wo, Wo, Ds, Wo, Dd, Wwf, Wwf, Ww, Ds, Dd, Dd, Rd, Dd, Dd, Dd, Gd, Re, Rd, Re
Re, Re, Re, Gs^Fp, Gs^Fmw, Re, Gs, Re, Re, Re, Gd, Re, Re, Ww, Ww, Wo, Wo, Wo, Wo, Wo, Wo, Wo, Wo, Wo, Wo, Wo, Wo, Wo, Wwr, Wo, Dd, Wo, Ww, Ww, Ds, Dd, Ds, Wwf, Wwf, Ds, Ds, Rd, Re, Re, Rd, Dd, Re, Rd, Rd, Dd, Dd
Re, Gd^Fdw, Gd, Gs^Fmw, Gs, Gs^Fmw, Wwf, Gd, Gd^Fdw, Re, Gd, Gd, Wwf, Ww, Ww, Ww, Wo, Wo, Wo, Wo, Wo, Wo, Wo, Wo, Wo, Wo, Wo, Wo, Ww, Wwr, Dd, Ds, Wwf, Ds, Ww, Dd, Ww, Wwf, Dd, Wwf, Ds, Rd, Ds, Re, Dd, Rd, Dd, Rd, Dd, Dd, Dd
Gd^Fmw, Re, Gs^Fp, Gs, Gs^Fmw, Wwf, Ww, Ww, Ww, Wwr, Wwf, Wwf, Ww, Ww, Wwr, Wo, Ww, Wo, Wo, Wo, Wo, Wo, Wo, Wo, Wo, Wo, Wo, Ww, Wo, Wwr, Wwr, Ww, Ww, Ww, Wwr, Ww, Ww, Ww, Ww, Ww, Wwf, Wwf, Wwf, Re, Dd, Dd, Ds, Rd, Rd, Dd, Ds
Gs^Fmw, Gs^Fms, Gs, Wwr, Wwr, Ww, Ww, Wwr, Wwr, Ww, Ww, Wwf, Gd, Ww, Ww, Wwr, Ds, Wwr, Wo, Wo, Wo, Wo, Wo, Wo, Wo, Wo, Wo, Wo, Wo, Wo, Wo, Wo, Ww, Wwr, Wwr, Wo, Wo, Wo, Ww, Ds, Ds, Ww, Ww, Rd, Rd, Ds, Wwf, Ds, Ds, Ds, Ds
Gd, Gd^Fmw, Gs, Gs, Wwr, Ww, Ww, Wwr, Wwr, Ww, Ww, Gd, Ww, Ww, Ww, Wwf, Ds, Wwr, Wwr, Wo, Wo, Wo, Wo, Wo, Wo, Wo, Wo, Wo, Wo, Wo, Wo, Wwr, Wwr, Ww, Ww, Wo, Wo, Ww, Wo, Ds, Ww, Ww, Wwf, Ds, Ds, Ds, Wwf, Ds, Wwf, Wwf, Wwf
Gs^Fms, Gs, Gs, Gs, Gs^Fms, Wwf, Gs^Fp, Ww, Wwr, Wwr, Ww, Ww, Wo, Ww, Wo, Wo, Wo, Wwr, Wo, Wo, Wo, Wo, Wo, Wo, Wo, Wo, Wo, Wo, Wo, Wo, Wwr, Ds, Ds, Ds, Ds, Wo, Wo, Wo, Wo, Wo, Ww, Ww, Wwf, Wwf, Ds, Ds, Ww, Ww, Ww, Ww, Ww
Gs, Gs^Fp, Gs, Gd^Fp, Gd^Fms, Gs^Fms, Gs^Fp, Wwf, Ww, Ww, Ww, Wwr, Ds, Wo, Wo, Wo, Wo, Wo, Wo, Wo, Wo, Wo, Wo, Xu, Xu, Wo, Wo, Wo, Wo, Wo, Wwr, Wwr, Wwr, Ww, Wo, Wo, Wo, Wo, Wo, Wo, Ds, Ds, Ww, Ww, Ww, Ww, Ww, Ww, Ww, Ww, Ww
Ww, Gs, Wwf, Gs, Gd^Fmw, Gs^Fms, Gs^Fmw, Gs^Fmw, Ww, Ww, Wwr, Ds, Ds, Wwr, Wo, Wo, Wo, Wo, Wo, Wo, Wo, Wo, Xu, Wo, Xu, Wo, Wo, Wo, Wo, Wo, Wo, Wo, Wo, Wo, Wo, Wo, Wo, Wo, Wo, Wo, Wo, Wo, Wo, Ww, Wo, Ww, Wo, Ww, Ww, Ww, Ww
Wo, Ww, Ww, Gs^Fmw, Gs^Fmw, Gs, Gs^Fdw, Wwf, Wwf, Wwr, Wo, Wwr, Wo, Wwr, Wo, Wo, Wo, Wo, Wo, Wo, Xu, Wo, Wo, Wo, Wo, Wo, Xu, Wo, Wo, Wo, Wo, Wo, Wo, Wo, Wo, Wo, Wo, Wo, Wwr, Wo, Wwr, Wo, Wo, Wo, Wo, Wo, Ww, Ww, Ww, Ww, Ww
Wo, Wo, Ww, Wwf, Gs, Gs, Ww, Wwf, Re, Re, Wo, Wo, Wo, Wo, Wo, Wo, Wo, Wo, Wo, Wo, Wo, Wo, Wo, Wo, Wo, Wo, Wo, Xu, Wo, Wo, Wo, Wo, Wo, Wo, Wo, Wo, Wo, Wwr, Wo, Wwr, Wwr, Wwr, Wo, Ds, Ds, Ww, Ww, Ww, Ds, Ds, Ds
Wo, Ww, Ww, Gs^Fdw, Gs, Gs^Fmw, Ww, Ww, Ww, Ww, Ww, Wwr, Wwr, Wo, Wo, Wo, Wo, Wo, Woby, Wo, Woby, Woby, Wo, Wo, Xu, Wo, Wo, Wo, Wo, Woby, Woby, Woby, Wo, Wo, Wo, Wo, Wo, Wo, Wo, Ds, Wwr, Wo, Ds, Ds, Ds, Ww, Ww, Wwf, Ds, Ds, Ds
Wo, Wo, Ww, Ww, Gs^Fdw, Gs^Fmw, Ww, Wo, Wo, Ww, Wwr, Ds, Wo, Wo, Wo, Wo, Wo, Wo, Woby, Woby, Xu, Xu, Wo, Wo, Wo, Xu, Wo, Wo, Wo, Woby, Xu, Wo, Wo, Wo, Wo, Wo, Wwr, Wo, Ww, Wwr, Ww, Ww, Ww, Wwf, Wwf, Ww, Wwf, Ds, Ds, Rd, Rd
Wo, Wo, Wo, Ww, Wo, Wo, Wo, Wo, Wo, Ds, Ds, Wo, Wo, Wo, Wo, Wo, Wo, Woby, Woby, Woby, Woby, Woby, Wo, Wo, Woby, Wo, Woby, Wo, Wo, Xu, Wo, Wo, Wo, Wo, Wo, Wo, Wwr, Wwr, Ww, Ww, Wwr, Wwr, Ww, Ds, Ds, Ds, Ds, Wwf, Dd, Dd, Rd
Wo, Wo, Wo, Wo, Wo, Wo, Wo, Wo, Wo, Wo, Wo, Wo, Wo, Wo, Wo, Wo, Xu, Xu, Wo, Wo, Wo, Wo, Wo, Wo, Woby, Woby, Xu, Wo, Wo, Woby, Woby, Wo, Wo, Wo, Wo, Wwr, Wo, Ww, Ww, Ww, Wwr, Wwr, Wwf, Ds, Ds, Rd, Rd, Rd, Re, Dd, Re
Wo, Wo, Wo, Wo, Wo, Wo, Wo, Wo, Wo, Wo, Wo, Wo, Wo, Wo, Wo, Wo, Wo, Wo, Wo, Xu, Xu, Xu, Woby, Wo, Woby, Woby, Xu, Woby, Wo, Xu, Xu, Wo, Wo, Wo, Wo, Wo, Wo, Ww, Wo, Ww, Ww, Ww, Wwf, Ds, Dd, Rd, Dd, Rd, Gd, Rd, Re
Ww, Wo, Wwr, Wo, Wwr, Wo, Wo, Wo, Wo, Wo, Wo, Wo, Wo, Wo, Wo, Wo, Wo, Wo, Wo, Woby, Woby, Woby, Woby, Woby, Woby, Woby, Woby, Xu, Wo, Wo, Xu, Wo, Wo, Wo, Wo, Wo, Wo, Wo, Ww, Ww, Re, Re, Re, Re, Rd, Dd, Dd, Dd, Rd, Re, Dd
Ww, Ww, Gd, Wwr, Wwr, Wo, Wo, Wo, Wwr, Wo, Wo, Wo, Wo, Wo, Wo, Wo, Wo, Woby, Woby, Xu, Woby, Woby, Woby, Woby, Woby, Woby, Woby, Xu, Wo, Wo, Wo, Woby, Wo, Wo, Xu, Wo, Wo, Wo, Ww, Ww, Wwf, Gd, Rd, Rd, Dd, Dd, Dd, Dd, Rd, Rd, Dd
Ww, Re, Gd, Gd^Fdw, Wwr, Wwr, Ww, Wwr, Wwr, Wwr, Wo, Wo, Xu, Wo, Wo, Woby, Wo, Wo, Wo, Xu, Xu, Woby, Wo, Woby, Woby, Woby, Wo, Wo, Woby, Wo, Wo, Wo, Wo, Wo, Xu, Wo, Wo, Wwr, Wwr, Ww, Ww, Rd, Wwr, Rd, Dd, Dd, Dd, Re, Rd, Dd, Dd
Wwr, Re, Wwf, Gd, Re, Ww, Ww, Ww, Wwr, Wo, Wo, Wo, Wo, Wo, Wo, Xu, Xu, Wo, Wo, Wo, Woby, Woby, Wo, Xu, Woby, Woby, Woby, Wo, Xu, Xu, Wo, Wo, Wo, Wo, Wo, Wo, Wo, Wo, Wo, Ww, Ww, Wwr, Wwr, Ds, Ds, Rd, Re, Re, Dd, Dd, Dd
Wwr, Wwr, Ww, Wwf, Ww, Ww, Ww, Wwr, Wo, Wo, Wo, Wwr, Wwr, Wo, Wo, Wo, Woby, Woby, Wo, Wo, Wo, Woby, Xu, Xu, Woby, Woby, Woby, Xu, Wo, Xu, Wo, Wo, Wo, Wo, Wo, Wo, Wo, Wo, Wo, Ww, Wo, Ww, Ww, Ds, Ds, Ds, Rd, Gd, Re, Dd, Gd
Ww, Ww, Wwr, Gs, Wwf, Ww, Wwf, Re, Wwr, Wo, Ds, Wwr, Wwr, Wo, Wo, Wo, Wo, Wo, Wo, Xu, Woby, Wo, Wo, Wo, Wo, Wo, Wo, Xu, Wo, Wo, Wo, Wo, Wo, Wo, Wo, Wo, Wog, Wo, Wog, Wo, Wo, Wo, Wo, Ww, Ds, Ds, Wwf, Re, Re, Gd, Gd
Ww, Ww, Re, Wwf, Gd^Fdw, Gd^Fdw, Wwf, Wwf, Ww, Re, Gd, Ds, Wo, Wo, Wo, Wo, Wo, Wo, Wo, Xu, Woby, Woby, Wo, Wo, Xu, Wo, Wo, Wo, Wo, Wo, Wo, Wo, Wo, Wo, Wo, Wog, Wog, Wo, Wo, Wo, Wog, Wo, Wo, Wwr, Ww, Ww, Ww, Wwf, Gs, Gd, Gs
Ww, Wwr, Re, Re, Gs, Gs, Re, Re, Wwf, Wwf, Wwf, Ds, Ww, Wo, Wo, Wo, Wo, Wo, Wo, Wo, Wo, Wo, Wo, Wo, Wo, Wo, Woby, Wo, Wo, Wo, Wo, Wo, Wo, Wo, Wo, Wo, Wog, Wog, Wog, Wog, Wwrg, Wog, Wwrg, Wwrg, Ww, Ww, Ww, Wwf, Gd, Gs, Gd
Ds, Wwr, Ds, Gd, Gs, Gs^Fmw, Gd^Fdw, Re, Wwf, Wwf, Gd, Ww, Ww, Wo, Wwr, Wo, Wo, Wo, Wo, Wo, Wo, Wo, Wo, Wo, Wo, Woby, Xu, Xu, Wo, Wo, Wo, Wo, Wo, Wo, Wo, Wo, Wo, Wog, Wog, Wwrg, Wwrg, Wwg, Wwg, Ww, Wwg, Wwr, Wwr, Ww, Gs, Gs, Gs
Rd, Ds, Ds, Gd^Fdw, Gd, Gd, Re, Re, Gd, Gd, Gd, Ww, Ww, Wwr, Wwr, Wo, Wo, Wo, Wo, Wo, Wo, Xu, Wo, Wo, Wo, Wo, Wo, Xu, Wo, Wo, Wo, Wo, Wog, Wo, Wog, Wo, Wog, Wo, Wog, Wog, Wog, Wwrg, Wwg, Wwg, Wwrg, Wwg, Ww, Gs, Re, Re, Gd
Rd, Ds, Rd, Rd, Gs^Fmw, Gs^Fdw, Re, Gs, Gs^Fmw, Gs^Fdw, Gs, Gd, Ww, Ww, Gd, Ds, Wo, Wo, Wo, Wo, Wo, Wo, Wo, Xu, Wo, Wo, Wo, Wo, Wo, Wo, Wo, Wog, Wog, Wog, Wog, Wo, Wo, Wog, Wog, Ai, Wwg, Wwrg, Wwg, Wwg, Wwg, Wwg, Wwg, Gd, Gs, Re, Gd
Gd^Fdw, Gd, Rd, Gd^Fdw, Gs^Fdw, Gs^Fp, Gs^Fmw, Gs, Gd, Gs, Gs^Fdw, Ww, Ww, Wo, Wo, Wo, Wo, Wo, Wo, Wo, Wo, Wo, Wo, Xu, Xu, Wo, Wo, Xu, Wo, Wo, Wog, Wog, Wog, Wog, Wog, Wog, Wog, Wog, Wog, Wwg, Ai, Wwg, Ai, Wwg, Wwf, Wwg, Gd, Gs, Re, Re, Re
Gs, Gd, Gd^Fmw, Gs, Gs^Fdw, Gs^Fp, Gs^Fdw, Gs^Fmw, Gd, Gd, Ww, Ww, Wwr, Wo, Wo, Wo, Ww, Wo, Wwr, Wo, Wwr, Wo, Wo, Wo, Wo, Wo, Wo, Wo, Wo, Wo, Wo, Wog, Wog, Wwg, Wwg, Wwg, Wog, Wog, Ai, Wog, Ai, Ai, Ai, Ai, Wwf, Re, Re, Re, Re, Re, Re
Gs, Gs, Gd, Re, Wwf, Wwf, Ww, Ww, Ww, Ww, Ww, Ww, Ww, Ww, Wwr, Ww, Wwr, Ww, Wwr, Wwr, Ds, Ds, Wo, Wo, Wo, Wo, Wog, Wo, Wog, Wo, Wog, Wo, Wog, Wog, Ai, Ai, Wog, Wwg, Wwg, Wwg, Wwg, Wwg, Wwg, Wwf, Wwf, Wwf, Gd, Gd, Re, Aa, Re
Gd^Fdw, Gd, Gs^Fmw, Re, Gs^Fmw, Ww, Gs, Wwf, Re, Re, Wwf, Ww, Ww, Ww, Ww, Wwr, Wwr, Ww, Ww, Gd, Re, Ds, Ds, Wo, Wo, Wo, Wo, Wog, Wog, Wog, Wog, Wog, Wog, Wwg, Wwg, Wwg, Wwg, Wwg, Ai, Ai, Wwf, Aa, Aa, Aa, Ai, Aa, Aa, Gd, Re, Aa, Aa
Gs^Fp, Gs^Fp, Gs^Fms, Gs^Fp, Gs^Fmw, Ww, Gs^Fmw, Gd, Gd, Re, Gs^Fdw, Wwf, Gs, Gs, Gd, Ww, Ww, Ww, Ww, Gd, Re, Ww, Wo, Wo, Wo, Wo, Wo, Wog, Wog, Wog, Wwg, Wog, Wwg, Wog, Wwg, Wwg, Ai, Wwg, Wwg, Wwg, Wwg, Aa, Aa, Ai, Ai, Aa, Ai, Re, Ai, Ai, Ai
Gs, Gs^Fms, Wwf, Wwf, Ww, Ww, Wwf, Gd^Fdw, Gd, Re, Gs^Fmw, Gs^Fdw, Gs^Fmw, Re^Fdw, Re, Gd^Fdw, Wwf, Ww, Ww, Wwr, Wwr, Wo, Wo, Wo, Wo, Wo, Wo, Wog, Wog, Ai, Wwg, Wwg, Wwg, Ai, Wwg, Wwg, Wwg, Ai, Wwf, Wwg, Wwf, Wwf, Ai, Ai, Aa, Ai, Ai, Ai, Aa, Aa, Aa
Gs^Fp, Gs^Fp, Ww, Ww, Ww, Gs^Fdw, Gs^Fmw, Gs, Gs^Fdw, Gd^Fmw, Gs^Fp, Gs^Em, Gs^Fp, Gd, Gd, Gd, Gd^Fdw, Ww, Ww, Wwr, Wo, Wo, Wo, Wo, Wo, Wo, Wo, Wo, Wog, Wog, Wog, Wog, Wwg, Wwg, Ai, Wwg, Wwg, Wwg, Ai, Ai, Ai, Ai, Ai, Aa, Aa, Ai, Aa, Ai, Ai, Aa, Ai
Wo, Gs^Fmw, Gs^Fmw, Gs, Ww, Gs, Gs, Gd, Gs, Gs^Fdw, Gs^Fms, Gs^Fms, Gs^Fms, Gs^Fdw, Gs, Re, Gs, Wwr, Wwr, Ww, Ww, Wo, Ww, Wo, Wo, Wo, Wo, Wog, Wo, Wog, Wwg, Wwg, Wwg, Wwg, Wwg, Ai, Wwg, Wwg, Ai, Ai, Ai, Ai, Ai, Ai, Ai, Aa, Ai, Aa, Ai, Ai, Ai
