Hhd, Hhd, Hhd^Ftd, Hhd, Mdd, Dd, Mdd, Hhd, Mdd, Dd, Hhd, Hhd, Hhd, Hhd, Hhd, Hhd, Mdd, Hhd, Hhd, Hhd, Hhd, Md, Mdd, Md, Hhd, Dd, Ql, Ql, Qxv, Ql, Ql, Mdd, Mdd, Ql, Qxv, Qxv, Qxv
Hhd, Mdd, Mdd, Hhd^Ftd, Mdd^Xm, Mdd, Mdd, Mdd, Hhd^Fts, Hhd^Ftd, Hhd, Rb, Rb, Dd, Drt, Mdd, Hhd, Hhd, Rb, Mdd, Mdd, Hhd, Mdd, Mdd, Hhd, Mdd, Qxv, Qxv, Mdd^Xm, Mdd, Mdd^Xm, Mdd, Mdd, Mdd, Mdd, Mdd, Mdd
Mdd, Mdd^Xm, Mdd^Xm, Mdd, Mdd^Xm, Mdd^Xm, Mdd, Mdd, Mdd^Xm, Mdd, Mdd, Mdd, Rb, Hhd, Qlf, Qlf, Qlf, Drt, Rb, Hhd, Mdd, Qlf, Hhd, Hhd, Hhd, Ql, Mdd, Qxv, Mdd, Mdd^Xm, Mv, Mdd^Xm, Mdd^Xm, Mdd^Xm, Mdd, Mdd, Mdd
Hhd, Mdd^Xm, Mdd, Mdd^Xm, Mdd^Xm, Mdd^Xm, Mdd^Xm, Mdd^Xm, Mdd, Mdd, Mdd, Mdd, Hhd, Mdd, Qlf, Uzw, Uzw, Uzw, Hhd, Hhd, Qlf, Qlf, Qlf, Qlf, Qlf, Hhd, Mm, Mv, Mm, Mm, Mm, Mm, Mdd^Xm, Mdd^Xm, Mdd, Mdd, Mdd
Mdd, Mdd, Mdd, Mdd^Xm, Mdd, Mdd^Xm, Mdd^Xm, Mdd^Xm, Mdd^Xm, Hhd^Ftd, Hhd^Fts, Hhd, Qdrt, Qlf, Hhd, Qlf, Qlf, Uzw, Uzw, Uzw, Qlf, Qlf, Qlf, Qlf, Qxv, Hhd, Mdd, Mm, Mdd, Mdd, Mv, Mdd^Xm, Mdd^Xm, Mdd^Xm, Mdd, Mdd, Mdd
Hhd, Mdd, Mdd, Mdd^Xm, Mdd^Xm, Mdd^Xm, Mv, Mdd^Xm, Mdd^Xm, Mdd, Mdd, Qdrt, Qdrt, Hhd, Hhd, Qlf, Drt, Uzw, Ql, Ql, Qlf, Qxv, Qxv, Ql, Qxv, Qxv, Ql, Ql, Ql, Mm, Mm, Mm, Mdd^Xm, Mdd^Xm, Mdd, Mdd, Mdd
Mdd, Mdd, Mdd, Mdd, Mdd^Xm, Md, Md, Md, Mdd, Hhd, Hhd, Qdrt, Hhd, Qdrt, Hhd, Drt, Qdrt, Drt, Qdrt, Qlf, Qlf, Qlf, Qlf, Qlf, Ql, Ql, Qlf, Ql, Qxv, Mdd, Hhd, Mdd, Mdd, Mdd, Rb, Rb, Hhd
Hhd, Mdd, Mdd, Hhd^Ftd, Mdd, Mdd, Mdd, Qlf, Qlf, Mdd, Hhd, Mdd, Hhd, Qdrt, Uzw, Uzw, Qdrt, Qdrt, Qlf, Qdrt, Qlf, Ql, Ql, Ql, Qxv, Qlf, Qlf, Ql, Qxv, Qxv, Qlf, Hhd, Hhd, Hhd, Hhd, Mdd, Hhd
Mdd, Mdd, Rb, Hhd, Mdd, Qlf, Ql, Qlf, Mdd, Qlf, Hhd, Ql, Ql, Ql, Uzw, Uzw, Uzw, Uzw, Qlf, Qlf, Qlf, Qlf, Ql, Qlf, Qlf, Qxv, Ql, Ql, Qlf, Qxv, Qlf, Qlf, Qlf, Qlf, Hhd, Mdd, Hhd
Hhd, Mdd, Rb, Mdd, Mdd, Qlf, Ql, Ql, Qlf, Qlf, Mdd, Hhd, Ql, Drt, Qdrt, Drt, Qdrt, Drt, Drt, Drt, Ql, Qlf, Ql, Qlf, Qxv, Qxv, Qlf, Ql, Qlf, Ql, Hhd, Mdd, Mdd, Qlf, Qlf, Hhd, Qlf
Qlf, Hhd, Mdd, Mdd, Mdd, Mdd, Mdd, Ql, Mdd, Ql, Hhd, Mdd, Hhd, Ql, Qdrt, Qdrt, Qlf, Qlf, Uzw, Ql, Qdrt, Ql, Ql, Ql, Ql, Qlf, Qlf, Qlf, Qlf, Hhd, Rb, Mdd, Hhd, Qlf, Hhd, Qlf, Qlf
Qlf, Qlf, Mdd, Mdd, Mdd, Ql, Ql, Ql, Mdd, Ql, Hhd, Hhd, Qlf, Qlf, Ql, Qlf, Qlf, Uzw, Qdrt, Uzw, Qdrt, Ql, Ql, Ql, Qlf, Qlf, Qlf, Qlf, Qlf, Qlf, Qlf, Rb, Qlf, Qlf, Hhd, Hhd, Qlf
Qlf, Hhd, Hhd^Ftd, Mdd, Mdd, Hhd, Ql, Qdrt, Drt, Ql, Ql, Qdrt, Qdrt, Qlf, Qdrt, Ql, Qlf, Drt, Ql, Qdrt, Ql, Ql, Ql, Qlf, Qdrt, Qlf, Uzw, Uzw, Hhd, Rb, Mdd, Hhd, Hhd, Hhd, Mdd, Hhd, Hhd
Hhd, Hhd, Mdd, Hhd^Ftd, Uzw, Rb, Qdrt, Qdrt, Drt, Drt, Ql, Ql, Qdrt, Qdrt, Qlf, Ql, Ql, Ql, Qdrt, Qdrt, Qdrt, Ql, Qdrt, Drt, Uzw, Qdrt, Uzw, Hhd, Rb, Rb, Mdd, Mdd, Hhd, Qlf, Mdd, Hhd, Hhd
Qdrt, Hhd, Mdd, Mdd, Hhd, Rb, Drt, Drt, Qdrt, Ql, Qdrt, Qlf, Qlf, Qlf, Ql, Ql, Drt, Ql, Qdrt, Qdrt, Ql, Ql, Qdrt, Uzw, Qdrt, Qdrt, Uzw, Drt, Hhd, Hhd, Drt, Hhd, Qlf, Qlf, Qlf, Qlf, Hhd
Hhd, Mdd, Hhd, Uzw, Uzw, Uzw, Uzw, Qdrt, Ql, Qdrt, Ql, Qlf, Qlf, Rb, Rb, Drt, Uzw, Qdrt, Ql, Ql, Uzw, Drt, Qdrt, Qdrt, Drt, Qdrt, Drt, Drt, Drt, Qlf, Drt, Drt, Drt, Qlf, Drt, Drt, Qlf
Hhd, Mdd, Qdrt, Hhd, Qdrt, Qdrt, Qdrt, Drt, Ql, Ql, Drt, Ql, Ql, Ql, Ql, Ql, Ql, Uzw, Ql, Ql, Ql, Uzw, Uzw, Drt, Dd, Uzw, Uzw, Uzw, Drt, Drt, Dd, Dd, Drt, Qlf, Rb, Drt, Qlf
Drt, Hhd, Qdrt, Qdrt, Qdrt, Dd, Rb, Drt, Dd, Drt, Drt, Drt, Ql, Ql, Ql, Ql, Drt, Uzw, Uzw, Drt, Dd, Uzw, Uzw, Uzw, Dd, Dd, Drt, Hhd, Drt, Drt, Drt, Dd, Rd, Drt, Rb, Hhd, Dd
Rb, Hhd, Rb, Dd, Qdrt, Qdrt, Drt, Rb, Drt, Ql, Ql, Ql, Ql, Qdrt, Drt, Ql, Ql, Ql, Ql, Ql, Qdrt, Drt, Qdrt, Hhd, Hhd, Drt, Drt, Hhd^Fts, Hhd^Fts, Drt, Hhd^Fts, Drt, Dd, Rd, Rd, Hhd, Dd
Drt, Rb, Drt, Qdrt, Drt, Qdrt, Drt, Drt, Rb, Rb, Ql, Ql, Qdrt, Qdrt, Uzw, Ql, Uzw, Qlf, Qlf, Qlf, Qlf, Qdrt, Qdrt, Drt, Drt, Rd, Hhd^Fts, Mdd, Mdd, Mdd, Hhd^Fts, Dd, Hhd, Rd, Ds, Ds, Ds
Rb, Rb, Rb, Drt, Qlf, Qlf, Qdrt, Drt, Ql, Ql, Ql, Qdrt, Qdrt, Uzw, Qdrt, Uzw, Qdrt, Qlf, Qlf, Qlf, Qdrt, Qdrt, Hhd, Drt, Hhd^Fts, Rd, Mdd, Mdd, Mdd, Mdd, Mdd, Hhd, Dd, Ds, Hhd, Hhd^Fts, Drt
Qdrt, Rb, Qlf, Drt, Qlf, Qdrt, Qdrt, Drt, Qdrt, Ql, Qdrt, Ql, Drt, Drt, Qdrt, Qdrt, Qdrt, Qdrt, Qlf, Dd, Drt, Qdrt, Qdrt, Dd, Hhd, Hhd, Hhd, Mdd, Hhd^Fts, Mdd, Hhd, Mdd, Hhd, Dd, Drt, Hhd^Fts, Dd
Qdrt, Qdrt, Drt, Qlf, Drt, Drt, Qdrt, Qdrt, Qdrt, Drt, Drt, Qdrt, Drt, Ql, Qdrt, Ql, Ql, Ql, Drt, Dd, Qlf, Drt, Qdrt, Drt, Drt, Dd, Drt, Hhd, Rb, Rd, Hhd^Fts, Hhd, Hhd^Ftd, Ds, Dd, Drt, Hd
Qdrt, Drt, Drt, Drt, Dd, Drt, Dd, Drt, Uzw, Uzw, Ql, Drt, Ql, Drt, Drt, Ql, Ql, Ql, Drt, Qlf, Qdrt, Drt, Dd, Drt, Hhd, Drt, Drt, Hhd, Rb, Ds, Ds, Ds, Ds^Ftd, Ds, Ds, Hd^Fts, Ds
Drt, Drt, Drt, Dd, Drt, Drt, Drt, Drt, Drt, Ql, Ql, Ql, Ql, Drt, Drt, Qlf, Qlf, Ql, Qlf, Qlf, Uzw, Qdrt, Qdrt, Dd, Hhd, Hhd, Rd, Rb, Rd, Ds, Hd, Ds^Do, Ds, Ds^Fts, Wwf, Ds^Do, Wwg
Drt, Drt, Dd, Rd, Rd, Drt, Dd, Drt, Drt, Drt, Drt, Ql, Ql, Ql, Uzw, Qlf, Uzw, Qlf, Qlf, Uzw, Uzw, Qdrt, Drt, Dd, Drt, Rd, Drt, Rd, Rd, Dd, Hd^Fts, Ds, Ds^Fts, Wwf, Wwf, Wwg, Wwg
Drt, Dd, Rd, Dd, Rd, Dd, Drt, Drt, Drt, Dd, Drt, Ql, Ql, Ql, Ql, Uzw, Qdrt, Uzw, Qdrt, Drt, Drt, Drt, Drt, Drt, Dd, Dd, Drt, Dd, Hd^Fts, Dd, Ds, Ds, Ds^Ftd, Ds^Fts, Wwf, Wwg, Wwg
Rb, Dd, Rd, Rb, Rb, Rb, Drt, Qlf, Rd, Rd, Ql, Ql, Uzw, Ql, Qdrt, Qdrt, Qlf, Qdrt, Drt, Drt, Dd, Drt, Drt, Drt, Drt, Drt, Ds, Ds, Ds^Do, Ds, Ds^Fts, Wwf, Wwf, Wwg, Ds, Wwg, Dd
Dd, Rd, Dd, Rb, Rd, Qlf, Qlf, Qlf, Rd, Ql, Ql, Ql, Ql, Uzw, Qdrt, Qdrt, Qlf, Qlf, Drt, Dd, Drt, Drt, Drt, Drt, Dd, Hd, Hd, Ds, Ds, Ds, Wwf, Wwf, Wwg, Wwg, Wwf, Wwf, Dd
Drt, Drt, Dd, Rd, Dd, Rd, Qlf, Qlf, Dd, Drt, Ql, Ql, Ql, Ql, Drt, Drt, Drt, Qlf, Qlf, Qlf, Dd, Dd, Drt, Drt, Drt, Dd, Hd^Fts, Ds, Rd, Ds, Ds, Wwf, Wwg, Wwg, Wwg, Dd, Dd
Drt, Drt, Dd, Dd, Drt, Qlf, Qdrt, Qlf, Qlf, Drt, Qdrt, Qdrt, Qdrt, Ql, Ql, Drt, Drt, Drt, Qlf, Qlf, Drt, Dd, Dd, Rd, Rd, Rd, Rd, Rd, Dd, Ds, Ds, Wwf, Wwf, Wwg, Wwf, Wwf, Dd
Dd, Dd, Dd, Dd, Drt, Qdrt, Drt, Qdrt, Uzw, Rb, Qlf, Qlf, Qdrt, Ql, Ql, Ql, Qdrt, Drt, Qdrt, Drt, Drt, Drt, Drt, Drt, Dd, Dd, Dd, Rd, Rd, Dd, Ds, Ds^Fts, Ds, Ds^Do, Ds^Fts, Ds, Dd^Fts
Drt, Drt, Rd, Drt, Drt, Drt, Rb, Uzw, Qlf, Drt, Qlf, Qlf, Drt, Qdrt, Ql, Dd, Qdrt, Qdrt, Dd, Drt, Dd, Dd, Dd^Fts, Drt, Drt, Drt, Drt, Rd, Dd, Dd, Dd, Ds, Ds, Ds, Ds, Ds, Ds
Dd, Rd, Rd, Drt, Hhd^Fts, Drt, Rd, Rb, Rd, Qlf, Dd, Qlf, Qlf, Drt, Qdrt, Qdrt, Qdrt, Qdrt, Qdrt, Dd, Drt, Drt, Drt, Drt, Drt, Dd^Fts, Drt, Dd, Dd, Hd^Fts, Hd^Fts, Hd, Dd, Dd, Ds^Ftd, Dd^Fts, Dd
Hhd, Hhd, Dd, Hhd, Rd, Hhd, Rd, Rb, Dd, Qlf, Dd, Rd, Qlf, Dd, Rd, Dd, Drt, Drt, Drt, Qdrt, Drt, Drt, Drt, Dd, Drt, Dd, Dd, Dd, Hd, Hd^Ftd, Hd^Fts, Hd, Hd^Fts, Dd, Dd, Ds, Dd^Fts
Dd, Hhd^Fts, Dd, Rd, Dd, Dd, Dd, Rd, Dd, Dd, Qdrt, Rd, Qdrt, Qlf, Rd, Drt, Drt, Drt, Dd, Drt, Dd, Dd, Drt, Drt, Drt, Drt, Drt, Dd^Fts, Dd, Hd, Dd^Ftd, Dd^Ftp, Hhd^Fts, Dd^Ftp, Dd, Ds, Dd
Dd, Dd, Rd, Dd, Hhd^Ftd, Hhd, Dd, Dd, Dd, Qdrt, Drt, Qdrt, Qdrt, Qdrt, Drt, Rd, Dd, Dd, Rd, Drt, Dd, Dd^Fts, Dd, Drt, Dd, Drt, Hd, Dd, Dd, Dd^Ftd, Hd^Fts, Dd^Ftp, Hd^Ftp, Hhd^Ftp, Hd^Ft, Hd^Ftd, Hd
Mdd, Hhd^Fts, Dd^Fts, Rd, Dd^Ftd, Mdd, Hhd^Ftd, Hhd, Dd, Drt, Dd, Dd, Drt, Qdrt, Drt, Drt, Dd, Rd, Rd, Dd, Dd, Dd^Fts, Dd, Dd, Drt, Hd^Ftd, Dd, Hd^Ftd, Dd^Ftd, Dd^Ftd, Mdd, Hhd^Ft, Hhd^Ftr, Hhd^Ftr, Hhd^Ft, Mdd, Mdd
Hhd, Hhd^Ftd, Hhd, Rd, Dd, Rd, Hhd, Dd, Dd, Dd, Dd, Dd, Drt, Drt, Drt, Dd, Dd, Rd, Dd, Dd, Dd, Dd, Dd, Dd, Dd, Drt, Dd, Dd, Dd, Hd^Ftd, Hhd, Hhd^Ft, Dd, Mdd, Dd, Mdd, Dd
