Xui, Xu, Xui, Xu, Xu, Xui, Xu, Xui, Xui, Xui, Xui, Xui, Xui, Xui, Xu, Xu, Xu, Xu, Xu, Xu, Ur, Xui, Xui, Xui, Xui, Xui, Uh, Xu^Foyg, Xu^Foyg, Xui^Foyg, Xui, Xui, Xui, Xui, Xui, Xui, Xui, Xui, Tyb, Spay, Spay, Spay, Spay, Spay
Xu, Xu, Xu, Xu, Xu, Xu, Xu, Xui, Xui, Xui, Xu, Xu, Xu, Xu, Xu, Xu, Uh, Uu, Uu, Uu, Aa, Xui, Aa, Xui, Xui, Uh, Xui, Uu, Ur, Tyb, Xui, Xui, Xui, Xui, Xui, Xui, Xui, Xui, Aa, Aa, Spay, Spay, Aa, Spay
Xu, Xu, Xu, Xu, Xui, Xu, Xui, Xui, Xui, Xui, Xu, Xu^Foyg, Xu^Foyg, Xu^Foyg, Xu, Uh, Uh, Xu, Xu, Ur, Ur, Aa, Aa, Xui, Xui, Xui, Xui, Xui, Ur, Xui, Xui, Xui, Xui, Xui, Uu, Uu, Spay, Spay, 1 Spay, Spay, Tyb, Aa, Xu, Spay
Xu, Xu, Xui, Xui, Xui, Xui, Xui, Xui, Xui, Xui, Xui, Xu^Foyg, Tyb^Hisy, Tyb, Xu, Xu, Xu, Xu, Xu, Tyb, Tyb, Xui, Xui, Xui, Xui, Spay, Spay, Spay, Aa, Xui, Aa, Aa, Spay, Aa, Spay, Tyb, Tyb, Tyb, Ur, Spay, Tyb, Xu, Xu, Xu
Xu, Xui, Xu, Xui, Xu, Xui, Xu, Xui, Xui, Xui, Xui, Xui^Foyg, Xui, Tyb, Tyb, Ai, Ai, Aa, Spay, Spay, Tyb, Aa, Xui, Xui, Xui, Spay, Spay, Aa, Aa, Tyb, Spay, Spay, Aa, Spay, Uu, Uu, Xui, Ur, Xui, Spay, Ur, Uu, Xu, Xu
Xu, Xu, Xu^Foyg, Xu, Xu, Xu, Xu, Xu, Xui, Xui, Xui, Xui, Xui, Xui, Ai, Ai, Xui, Ai, Xui, Aa, Xui, Aa, Spay, Aa, Spay, Tyb, Tyb, Aa, Aa, Tyb, Tyb, Tyb, Xui, Xui, Xui, Xui, Xui, Xui, Xui, Ur, Spay, Uu, Xu, Xu
Xu, Xu^Foyg, Uu, Xu^Foyg, Xu^Foyg, Xu, Xu, Xu^Foyg, Xui^Foyg, Xui, Aa, Tyb, Tyb, Xui, Tyb, Ai, Xui, Xui, Xui, Xui, Xui, Aa, Xui, Spay, Xui, Xui, Aa, Aa, Aa, Aa, Xui, Tyb, Xui, Xui, Xui, Xui, Xui, Aa, Spay, Spay, Xui, Uu, Uh, Xu
Xu, Xu, Xu, Uu, Uu, Xu, Xu, Tyb^Hsry, Uu, Xui, Aa, Aa, Tyb, Tyb, Tyb, Aa, Aa, Xui, Aa, Xui, Xui, Xui, Tyb, Tyb, Xui, Xui, Xui, Xui, Xui, Spay, Xui, Xui, Xui, Xui, Xui, Xui, Xui, Aa, Spay, Xui, Xui, Tyb^Hisy, Xu^Foyg, Xui^Foyg
Xu, Xu, Xu^Foyg, Uu^Hsry, Tyb, Xu, Ai, Ai, Ai, Uu, Aa, Aa, Ai, Tyb, Ai, Tyb, Aa, Aa, Xui, Xui, Xui, Xui, Tyb, Xui, Xui, Spay, Spay, Xui, Xui, Spay, Aa, Aa, Aa, Aa, Xui, Xui, Aa, Tyb, Xui, Tyb, Xui, Xui^Foyg, Xui, Xui
Xu, Xu, Xu, Xui^Foyg, Tyb, Ai, Xui, Ai, Ai, Aa, Aa, Ai, Ai, Ai, Ayb, Ai, Aa, Aa, Tyb, Tyb, Tyb, Aa, Aa, Xui, Tyb, Xui, Aa, Xui, Aa, Spay, Tyb, Aa, Aa, Xui, Xui, Xui, Aa, Tyb, Xui, Xui, Xui, Xui, Xui^Foyg, Xui
Xui, Xu, Xu, Xui^Foyg, Xui^Foyg, Xui, Xui, Xui, Ai, Ai, Tyb, Tyb, Tyb, Ayb, Ayb, Ai, Ai, Tyb, Tyb, Ai, Ai, Ai, Aa, Aa, Tyb, Tyb, Spay, Aa, Aa, Tyb, Tyb, Aa, Aa, Tyb^Hisy, Xui^Foyg, Xui, Xui, Xui, Xui, Xui, Uh, Xui, Xu^Foyg, Xu
Xui, Xui, Xui, Xui, Xui, Xui, Aa, Xui, Aa, Uu, Aa, Ai, Ai, Ai, Ayb, Ayb, Ai, Tyb, Aa, Ai, Ai, Ai, Ai, Tyb, Tyb, Spay, Xu, Aa, Xu, Aa, Xu, Spay, Tyb, Xu^Foyg, Xu, Xu^Foyg, Xu^Foyg, Xui^Foyg, Tyb^Hsry, Xui, Uh^Foyg, Tyb^Hsry, Xu^Foyg, Xu
Xui, Xui, Xui, Xui, Tyb^Hisy, Xui, Tyb, Aa, Xu, Uu, Uu, Ai, Ai, Ayb, Ayb, Ai, Ai, Ai, Aa, Aa, Tyb, Tyb, Tyb, Tyb, Xu, Xu, Xu, Xu, Xu^Foyg, Xu, Xu, Spay, Spay, Xu, Xu, Xu, Xu, Xu^Foyg, Uu, Uu, Uu^Foyg, Xu, Xu^Foyg, Xui^Foyg
Xui, Xui, Xui, Xui, Aa, Aa, Aa, Xu, Xu, Xu, Xu, Aa, Ai, Ai, Ai, Ai, Tyb, Tyb, Aa, Aa, Aa, Xui, Xui, Tyb, Tyb, Uu, Xu, Xu, Xu, Xu, Xu, Spay, Xu, Tyb, Spay, Tyb, Ur, Uu^Foyg, Ur, Uh^Foyg, Uh, Tyb^Hsry, Xui^Foyg, Xui
Xui, Xui, Xui, Xui, Xui, Xui, Tyb, Xu, Tyb, Xu, Ai, Aa, Aa, Aa, Tyb, Ai, Tyb, Aa, Aa, Xui, Xui, Xui, Xui, Xui, Aa, Uu, Aa, Xu, Uh, Xu, Xu, Xu, Xu, Xu, Xu, Spay, Spay, Ur, Uu, Uu, Xui, Xui^Foyg, Xui, Xui
Xui, Xui, Xui^Foyg, Xui^Foyg, Xui, Xui, Aa, Tyb, Tyb, Ai, Ai, Ai, Uu, Aa, Uu, Tyb, Tyb, Tyb, Tyb, Xui, Xui, Xui, Xui, Xui, Xui, Aa, Xui, Uh, Xu, Xu, Xu, Xu, Xu, Xu, Xu, Tyb, Tyb, Tyb, Uu, Xui, Xui, Xui, Xui, Xui
Xui, Xui, Xui^Foyg, Xui^Foyg, Aa, Aa, Tyb^Hisy, Xu^Foyg, Xu, Xu, Xu, Ai, Xu, Uu, Uu^Hisy, Xu^Foyg, Xui, Xui, Tyb, Aa, Aa, Aa, Xui, Xui, Tyb, Aa, Aa, Uu, Xu, Xu, Xu, Uh, Uu^Foyg, Uu, Uu, Tyb, Spay, Tyb, Spay, Xui, Xui, Xui, Xui, Xui
Xui^Foyg, Xui^Foyg, Xui^Foyg, Tyb, Tyb, Xu, Xu, Xu^Foyg, Xu, Xu, Xu, Xu, Xu, Xu^Foyg, Xu^Foyg, Xu^Foyg, Xui^Foyg, Xui^Foyg, Xui^Foyg, Uu, Uu, Xui, Aa, Xui, Aa, Tyb, Xu, Xu, Xu^Foyg, Xu^Foyg, Xu, Xu, Ur^Foyg, Ur^Foyg, Ur^Foyg, Ur^Foyg, Spay, Tyb, Tyb, Spay, Uu, Xui, Uh, Xui
Xui^Foyg, Xui^Foyg, Uu^Hsry, Uu^Foyg, Uu, Xu^Foyg, Xu, Xu, Xu, Xu, Xu, Xu, Xu, Xu, Xu, Xu, Xu^Foyg, Xui^Foyg, Uu^Hsry, Uh, Uu, Tyb, Aa, Aa, Xu, Uu, Xu, Xu, Xu^Foyg, Uh^Foyg, Uh^Foyg, Uu, Uu^Foyg, Spay, Spay, Spay, Xui, Xui, Xui, Xui, Uu, Uu, Xui, Xui
Xui^Foyg, Xui^Foyg, Xu^Foyg, Uu, Xu^Foyg, Xu^Foyg, Xu, Xu, Spay, Xu, Aa^Hisy, Xu, Xu, Xu, Uu, Xu^Foyg, Xu, Xu^Foyg, Uu^Foyg, Uh^Foyg, Xu^Foyg, Xu^Foyg, Tyb, Aa, Xu, Uh, Uh, Xu, Xu, Xu^Foyg, Xu, Xu^Foyg, Xu^Foyg, Tyb, Tyb^Hisy, Spay, Xui, Xui, Xui, Xui, Xui, Xui, Xui, Xui
Xu, Xu, Xu^Foyg, Uh, Xu^Foyg, Xu, Xu, Uu, Spay, Spay, Aa, Aa, Aa, Tyb, Tyb, Uh^Foyg, Uh^Foyg, Tyb^Foyg, Tyb, Tyb, Xu^Foyg, Xu^Foyg, Tyb, Aa, Uu, Uu, Xu, Xu, Xu, Xu, Xu, Xu, Xu^Foyg, Xu^Foyg, Xu^Foyg, Xu^Foyg, Xui, Xui, Xui, Xui, Xui, Xui, Xui, Xui
Xu, Xu^Foyg, Xu^Foyg, Uh, Uu^Foyg, Uu, Ur, Ur, Uu, Tyb, Tyb, Tyb, Uu, Tyb, Uu^Foyg, Xui^Foyg, Xui^Foyg, Xui^Foyg, Tyb, Xu^Foyg, Aa, Aa, Aa, Tyb, Aa, Uu, Aa, Xu, Xu, Xu, Xu, Xu, Xu, Xu, Xui, Xui, Xui, Xui, Xui, Xui, Xui, Xui, Xui, Xui
Xui, Xu, Xu, Xu, Xu, Uu, Xu, Uu, Xu, Xu, Xu, Xu, Uu^Hsry, Uu, Uu, Xui^Foyg, Xui^Foyg, Xui, Uu^Foyg, Tyb, Aa^Hisy, Xui^Foyg, Xui, Xui^Foyg, Aa, Aa, Uu, Xu, Xu, Xu, Xu, Xu, Xu, Xu, Xui, Xui, Xui, Xui, Xui, Xui, Xui, Xui, Xui, Xui
Xui, Xu, Xu, Xu, Xu, Xu, Xu, Xu, Xu, Xu, Xu, Xu, Xui, Uh, Aa, Aa, Xui^Foyg, Xui, Uu^Foyg, Xui^Foyg, Xui^Foyg, Xui^Foyg, Xui, Xui, Xui, Aa, Uu, Uh, Uh, Xu, Xu, Xu, Xu, Xui, Xui, Xui, Xui, Xui, Xui, Xui, Xui, Xui, Xui, Xui
Xui, Xu, Xui, Xu, Xui, Xui, Xui, Xu, Xu, Xu, Xui, Xui, Xui, Uh, Aa, Tyb, Tyb, Tyb, Aa, Uu, Xui^Foyg, Xui, Xui^Foyg, Xui, Xui, Tyb, Xu, Xu, Uu, Xu, Xu, Xu, Xu, Xui, Xui, Xui, Xui, Xui, Xui, Xui, Xui, Xui, Xui, Xui
Xui, Xui, Xui, Xui, Xui, Xui, Xui, Xui, Xui, Xui, Xui, Xui, Qxyi, Qxyi, Aa, Aa, Xu, Tyb, Xu, Aa, Aa, Aa, Tyb, Tyb, Tyb, Aa, Aa, Xu, Aa, Xu, Xu, Xu, Xui, Xui, Xui, Xui, Xui, Xui, Xui, Xui, Xui, Xui, Xui, Xui
Xui, Xui, Xui, Xui, Xui, Xui, Xui, Xui, Xui, Xui, Xui, Xui, Qxyi, Aa, Aa, Xu, Xu, Xu, Xu, Tyb, Aa, Aa, Xu, Tyb, Tyb, Aa, Xu, Tyb, Aa, Aa^Hisy, Xui, Xui, Xui, Xui, Xui, Xui, Xui, Xui, Xui, Xui, Xui, Xui, Xui, Xui
Xui, Xui, Xui, Xui, Xui, Xui, Xui, Xui, Xui, Xui, Xui, Qxyi, Tyb, Aa, Xu, Aa, Xu, Uu, Aa, Aa, Aa, Tyb, Uu, Uu, Xui, Uu, Xu, Xu, Fyp, Aa, Aa, Xui, Fyp, Xui, Xui, Xui, Xui, Xui, Xui, Xui, Xui, Xui, Xui, Xui
Xui, Xui, Xui, Xui, Xui, Xui, Xui, Xui, Xui, Xui, Aa, Tyb, Tyb, Tyb, Xu, Qxyi, Qxyi, Uu, Xui, Aa^Hisy, Xui, Xui, Xui, Xui, Xui, Uu, Tyb, Fyp, Aa, Xui, Xui, Fyp, Xui, Xui, Xui, Xui, Xui, Xui, Xui, Xui, Xui, Xui, Xui, Xui
Xui, Xui, Xui, Xui, Xui, Xui, Xui, Xui, Xui, Aa, Qxyi, Xu, Xu, Aa, Qxyi, Qxyi, Bluy, Xui, Xui, Xui, Xui, Xui, Xui, Xui, Xui, Xui, Tyb, Aa, Aa, Aa, Fyp, Wwby, Wwby, Wwby, Wwby, Xui, Fypd, Xui, Xui, Xui, Xui, Xui, Xui, Xui
Xui, Xui, Xui, Xui, Xui, Xui, Xui, Xui, Xui, Aa, Qxyi, Xu, Xu, Aa, Tyb, Bluy, Bluy, Xui, Aa, Xui, Xui, Xui, Xui, Xui, Xui, Ai, Ai, Ai, Aa, Aa, Aa, Ai, Ai, Ai, Fypd, Fypd, Fyp, Xui, Xui, Xui, Xui, Xui, Xui, Xui
Xui, Xui, Xui, Xui, Xui, Xui, Xui, Xui, Tyb, Qxyi, Bluy, Xu, Qxyi, Tyb, Qxyi, Tyb, Qxyi, Tyb, Xui, Aa, Xui, Xui, Xui, Xui, Aa, Aa, Wwby, Aa, Ai, Aa, Fyp, Fyp, Ai, Ai, Ai, Fypd, Ai, Fyp, Ai, Tyb, Ai, Fyp, Xui, Xui
Xui, Xui, Xui, Xui, Xui, Xui, Xui, Xui, Tyb, Bluy, Bluy, Xu, Qxyi, Qxyi, Bluy, Qxyi, Bluy, Aa, Qxyi, Xui, Xui, Xui, Xui, Wwby, Wwby, Wwby, Wwby, Fyp, Fyp, Ai, Ai, Fyp, Fyp, Wwby, Wwby, Wwby, Wwby, Ai, Tyb, Tyb, Fypd, Ai, Xui, Xui
Xui, Xui, Xui, Xui, Xui, Xui, Xui, Xui, Xui, Qxyi, Qxyi, Qxyi, Bluy, Qxyi, Bluy, Bluy, Bluy, Bluy, Qxyi, Aa, Xui, Xui, Xui, Xui, Wwby, Wwby, Xu, Fypd, Fypd, Ai, Wwby, Ai, Ai, Wwby, Wwby, Wwby, Wwby, Fypd, Fypd, Ai, Fypd, Ai, Ai, Ai
Xui, Xui, Xui, Xui, Xui, Xui, Xui, Xui, Xui, Qxyi, Bluy, Qxyi, Bluy, Bluy, Bluy, Qxyi, Bluy, Qxyi, Tyb, Aa, Xui, Xui, Xui, Xui, Wwby, Xu, Xu, Xu, Fypd, Fypd, Wwby, Ai, Fyp, Fyp, Ai, Wwby, Wwby, Wwby, Woby, Woby, Woby, Woby, Woby, Woby
Xui, Xui, Xui, Xui, Xui, Xui, Xui, Xui, Tyb, Xui, Bluy, Qxyi, Qxyi, Qxyi, Qxyi, Qxyi, Qxyi, Tyb, Aa, Xui, Xui, Xui, Xui, Aa, Ai, Xu, Ai, Xu, Xu, Wwby, Wwby, Wwby, Wwby, Ai, Fyp, Fyp, Wwby, Woby, Woby, Fyp, Woby, Woby, Woby, Woby
Xui, Xui, Xui, Xui, Xui, Xui, Xui, Tyb, Aa, Bluy, Xui, Xui, Bluy, Qxyi, Bluy, Xui, Xui, Xui, Xui, Xui, Xui, Xui, Xui^Foyg, Aa, Tyb, Ai, Xu^Foyg, Xu, Woby, Xu, Woby, Wwby, Ai, Ai, Ai, Fyp, Fyp, Wwby, Ai, Woby, Woby, Woby, Woby, Woby
Xui, Xui, Xui, Xui, Xui, Xui, Xui, Xui, Aa, Aa, Bluy, Bluy, Xui, Bluy, Qxyi, Bluy, Tyb, Tyb, Xui, Xui, Xui, Xui, Xui, Xui, Xui^Foyg, Tyb^Hsry, Xu^Foyg, Xu, Woby, Xu, Woby, Woby, Woby, Woby, Fypd, Fyp, Fyp, Ai, Woby, Woby, Woby, Woby, Woby, Woby
Xui, Xui, Xui, Xui, Xui, Xui, Xui, Xui, Xui, Xui, Xui, Xui, Xui, Qxyi, Xui, Xui, Xui, Xui, Xui, Xui, Xui, Xui, Xui, Xui, Xui, Xu^Foyg, Xu, Xu, Xu, Woby, Xu, Woby, Xu, Xu, Tyb, Fypd, Woby, Woby, Woby, Woby, Woby, Woby, Woby, Woby
Xui, Xui, Xui, Xui, Xui, Xui, Xui, Xui, Xui, Xui, Xui, Xui, Xui, Xui, Xui, Xui, Xui, Xui, Xui, Xui, Xui, Xui, Xui, Xui, Xui, Xui, Xu, Xu, Xu, Xu, Xu, Xu, Xu, Xu, Xu, Tyb, Woby, Woby, Woby, Woby, Woby, Woby, Woby, Woby
Xui, Xui, Xui, Xui, Xui, Xui, Xui, Xui, Xui, Xui, Xui, Xui, Xui, Xui, Xui, Xui, Xui, Xui, Xui, Xui, Xui, Xui, Xui, Xui, Xui, Xui, Xu, Xu, Xu, Xu, Xu, Xu, Xu, Xu, Xu, Woby, Woby, Woby, Woby, Woby, Woby, Woby, Woby, Woby
